2113313131320100002a2b2b1d3b3b3b3b3b3b3b
1332010000000102003a1e2b2c01010000030100
22003f000202020103002a2b2d1b1b1b1b1b1b1b
320204010100000001003a3b3b1e2b2b1d3b3b3b
010101000000010000007374753a3b3b3c000003
01030300010200000000838485000002e3000000
0400010101010202000093949501000000000200
01020100020001000000010000013d0202000100
0300020200000000000002030002010000000210
1112e20000000300151700030100000000001024
212312e400000003252816161616171011112421
2121231200000000252626262626272021212121
tilesheet midlands
song toil_and_trouble
sprite 13 1 treasure item:FEATHER 0 0
neighborn 2
neighbore 13
neighbors 19
neighborw 23
hero 11 6 spell:HOME
door 2 2 3 2 2
