5c5c5c5c5c5c5c5c5c5c5c5c5c5c5c5c5c5c5c5c
6c6c8c6c6c6c6c6c6c6c6c6c6c6c6c6c6c6c6c6c
1205050110120305000102000204010110111111
2200020020220000020001000000000020212121
2200000120220010111111111112010020212121
2200000020220130313131311422000330313131
2200000120220001000101022023120003000102
2200010020231111111201013014231200030001
2204000030313131313201000120212311111111
2312000103000000020102040020212121212121
2123120201010001010001101124212121212121
2121231111111111111111242121212121212121
tilesheet mountains
neighbore 9
neighbors 26
sprite 2 6 treasure item:CHALK 0 0
sprite 9 3 skyleton 0 0 0
door 2 1 11 10 9
song seven_circles
