2b2b2b2b2b2b2b2b2b2b2b2b2b2b2b2b2b2b2b2b
2b2b2b2b2b2b2b2b2b2b2b2b2b2b2b2b2b2b2b2b
2b1db0b1b2b3b4b5b6b7b8b9babbbcbdbebf1e2b
2b2c000000000000000000000000000000002a2b
2b2d1b1b1b1b1b1b1b1c001a1b1b1b1b1b1b2e2b
2b1dc0c1c2c3cbcccd3c003ac4c5c6c7c8c91e2b
2b2c00000000dbdcdd0000000000000000002a2b
2b2c000000000000000000000000000000002a2b
2b2d1b1c0000000000000000000000001a1b2e2b
2b2b2b2d1b1b1b1b1b1011121b1b1b1b2e2b2b2b
2b2b2b2b2b2b2b2b2b2021222b2b2b2b2b2b2b2b
2b2b2b2b2b2b2b2b2b2b2b2b2b2b2b2b2b2b2b2b
tilesheet caves
flags indoors
door 10 9 10 2 1
sprite 7 7 treasure item:CHALK 0 0
song seven_circles
