3b1e2b2b2b2c0201010300030200002a2b2b2b2b
023a1e2b2b2c0101000238000201022a2b1d3b3b
02003a1e2b2c0115170003011517003a3b3c0301
0201023a3b3c0125281616162927030400000002
0000030203010125262626262627020300010000
0001020001020125262626262627010203000102
0000020000000035363619261837030000000000
000000000003013d003d2526273d000000020000
0100000000000001030206060600000103000001
0000020000000000020025262701020102151616
0000000000001516161629262816161616292626
1616161616162926262626262626262626262626
tilesheet beach
neighbore 20
neighborw 22
neighborn 24
neighbors 41
sprite 10 0 firewall 0 0 0
sprite 11 8 tolltroll gs:tolltroll 0 0
sprite 15 5 lobster 0 0 0
sprite 5 6 lobster 0 0 0
song eye_of_newt
