6262455252525252525252525252525252532021
0000614552524462626262626262624552532021
0000006162626300000000000000006162632021
4800000000000000464800000000000000003031
59474747474747475a5800006500000000000000
676767674a575757496800000000000000000000
6f6e6f6f664a5757580000000000000000000000
000000006f666767686f6f6e6f00000000000000
0000000000000000000000006e00000000000000
000000006f464747480000006e00000000001011
000000006f565757580000006f00000010112421
4d0000006e565757580000006f00000020212121
tilesheet desert
neighbore 1
neighborn 9
neighbors 24
neighborw 26
sprite 9 2 pushblock 0 0 0
song eye_of_newt
