6d0000006e565749680000006e00000030311421
000000006e564968000000006f0000004b4d3031
000000006f565800000000006e0000005b5e4c4c
000000006f565947480046486e0000006b6c4f5c
000000006e565757580066680000000000005b5c
00000000465a5757580000000000000000005b5c
6f6f000056575749680046480046474800005b5c
4747480056574968000056580056575800006b4f
575758006667680000006668005657580000005b
5749680000000000080909090a5657580000005b
6768000000000000000000000066676805004b5f
4c4c4c4c4c4d0000000000000000004b4c4c5f5c
tilesheet desert
neighborn 23
neighbore 19
neighbors 21
neighborw 25
sprite 12 10 treasure item:COMPASS 0 0
sprite 10 9 saw 0 0 0
sprite 10 11 firewall 0 0 0
song eye_of_newt
