5252525252525252525252524462626262626262
5252524462626262626262626300000000000000
52524463000000006f0000000000000000000000
52525300000000006f000000000000006e464747
52446300006e00006e006e0041424346475a5757
52530000006f00006e0000415544635657496767
626300006f6e0000000041554463465a49686f6e
4c4d000000006f000041554463465a49686e0000
5c5d00000000004142554463465a57586f000000
4e6d000000000061626263465a5757586f000000
5d000000004647474747475a575757586f000000
5d000000465a575757575757575757586e00004b
tilesheet desert
song eye_of_newt
neighbors 25
neighbore 23
neighborn 10
neighborw 46
facedir gs:dirfirea gs:dirfireb
sprite 5 1 firenozzle_s 2 0 gs:dirfireb
sprite 8 8 firenozzle_n 2 0 gs:dirfirea
sprite 5 5 firenozzle_e 2 0 gs:dirfireb
sprite 5 4 firenozzle_w 2 0 gs:dirfirea
sprite 9 2 bittattle gs:dirfirea gs:dirfireb 0
