0101010101010101010101010101010101010101
0101010101010101010101010101010101010101
0101010122232323232323232323232201010101
0101010120313231333134313531312001010101
0101010120000000000000000000002001010101
0101010120000000000000000000002001010101
0101010120000000000000000000002001010101
0101010120000000000000000000002001010101
0101010130111111110200041111113001010101
0101010121212121211213142121212101010101
0101010101010101010101010101010101010101
0101010101010101010101010101010101010101
tilesheet villint
indoors
sprite 7 4 treasure item:PITCHER 0 0
door 10 9 5 16 1
