0101010101010101010101010101010101010101
0101010101010101010101010101010101010101
0101010101220523232323232323232201010101
0101010101201516171831263131312001010101
0101010101200000000000363737372001010101
0101010101200000000000000019002001010101
0101010101200000000000272829002001010101
0101010101200000000000000000002001010101
0101010101300200041111111111113001010101
0101010101211213142121212121212101010101
0101010101010101010101010101010101010101
0101010101010101010101010101010101010101
tilesheet villint
flags indoors
door 7 9 8 16 3
sprite 10 4 3 item:VIOLIN 0 0
sprite 13 3 bartender 0 4 0
sprite 11 6 pamcake 1 0 0
