0101010101010101010101010101010101010101
0101010101010101010101010101010101010101
0101010122232323232323222323232201010101
0101010120212121212121202121212001010101
01010101201a1b1b1b1b1c300606062001010101
01010101202a2b2b2b2b2c210608062001010101
01010101202a2b2b2b2b2c060606062001010101
01010101203a3b3b3b3b3c220606062001010101
01010101302323230a0609302323233001010101
0101010121212121120714212121212101010101
0101010101010101010101010101010101010101
0101010101010101010101010101010101010101
tilesheet villint
indoors
door 9 9 8 4 3
sprite 7 5 moonsong gs:moonsong 0 0
sprite 11 6 gate gs:mns_switch 0 0
sprite 5 4 treadle gs:mns_switch 0 0
door 13 5 31 13 5
