0101015151515354555151519596975101010101
010101515151636465515151a5a6a75101010101
0101015151515151515151515050505101010101
0101015173737172737351505070505101010101
0101015184848182838150505050505101010101
0101015150505050505050505151515101010101
0101015150616250616250515a5b5c5101010101
0101015150505050505050516a6b6c5101010101
0101015150616250616250517a7b7c5101010101
0101015150505050505050505050505101010101
0101015151515160515151515151515101010101
0101010101010101010101010101010101010101
tilesheet villint
flags indoors
song snowglobe
door 7 10 7 11 5
door 13 3 33 10 7
hero 13 8 spell:TELE1
