0101010101010101010101010101010101010101
0101010101010101515156575859515101010101
0101010101010101515166676869515101010101
0101010101010101515176777879515101010101
0101010101010101515186878889515101010101
0101010101010101515151515151515101010101
0101010101010101515050505050505101010101
0101010101010101515080505050505101010101
0101010101010101515050505050505101010101
0101010101010101515151515160515101010101
0101010101010101010101010101010101010101
0101010101010101010101010101010101010101
tilesheet villint
door 13 9 7 16 1
door 10 7 32 13 3
