2b2b2b2b2b2b1d3b3b3b1e2b2b2b2b2b2b2b2b2b
2b2b2b2b1d3b3c0000003a3b1e2b2b2b2b2b2b2b
2b2b1d3b3c000000010000003a3b1e2b2b2b2b2b
2b1d3c00000000000000000000003a1e2b2b2b2b
2b2c000000000015161617000000003a1e2b2b2b
2b2c00000000152926262816170000003a1e2b2b
2b2c0000000035361926261837000000002a2b2b
2b2d1c00000000003536363700000000002a2b2b
2b2b2d1c00000000000000000000001a1b2e2b2b
2b2b2b2d1b1b1b1c0000000000001a2e2b2b2b2b
2b2b2b2b2b2b2b2d1011121b1b1b2e2b2b2b2b2b
2b2b2b2b2b2b2b2b2021222b2b2b2b2b2b2b2b2b
tilesheet caves
song seven_circles
indoors
door 9 10 9 6 1
door 8 2 35 8 2
sprite 8 3 watchduck item:MATCH 0 0
