2b2b2b2b2b1d3b3b3b1e2b2b2b2b2b2b2b2b2b2b
2b2b2b2b2b2c0000002a2b2b2b2b2b2b2b2b2b2b
2b2b2b2b2b2c0001003a3b3b3b3b3b3b3b3b3b3b
2b2b2b2b2b2c0000000000000000000000000000
2b2b2b2b2b2d1b1b1b1b1b1b1b1b1b1b1b1b1b1b
2b2b2b2b2b2b2b2b2b2b1d3b3b3b3b3b3b1e2b2b
2b2b2b2b2b2b2b2b2b2b2c0000000000002a2b2b
1d3b3b3b3b3b3b3b3b3b3c001a1b1b1c002a2b2b
2c00000000000000000000002a2b2b2c002a2b2b
2c0001001a1b1b1b1b1b1c002a1d3b3c003a3b3b
2c0000002a2b2b2b2b2b2c002a2c000000000000
2d1b1b1b2e2b2b2b2b2b2d1b2e2d1b1b1b1b1b1b
tilesheet caves
flags dark indoors
neighbore 35
door 7 2 37 7 2
door 2 9 37 2 9
song seven_circles
