2b2b2b2b2b1d3b3b3b3b3b3b3b3b3b1e2b2b2b2b
2b2b2b2b2b2c0000000000000000003a3b1e2b2b
2b2b2b2b2b2c00020000000000000000003a3b3b
2b2b2b2b2b2c0000001a1b1b1b1c000000000000
2b2b2b2b2b2d1b1b1b2e2b2b2b2d1c0000000000
2b2b2b2b2b2b2b2b2b2b2b2b2b2b2d1b1b1b1b1b
2b2b2b2b2b2b2b2b2b2b2b2b2b2b2b2b1d3b3b3b
1d3b3b3b1e2b2b2b2b2b2b2b2b1d3b3b3c000000
2c0000003a3b3b3b3b3b3b3b3b3c000000001a1b
2c000200000000000000000000000000001a2e2b
2c0000001a1b1b1b1b1b1b1b1b1b1b1b1b2e2b2b
2d1b1b1b2e2b2b2b2b2b2b2b2b2b2b2b2b2b2b2b
tilesheet caves
song seven_circles
flags dark indoors
neighbore 40
door 7 2 36 7 2
door 2 9 36 2 9
