2b2b2b2b1d3b1e2b2b2b2b1d3b3b1e1d3b3b3b1e
2b2b2b2b2c002a2b2b2b2b2c00002a2c0000002a
1d3b3b3b3c003a3b3b3b3b3c001a2e2c0001002a
2c0000000000000000000000003a3b3c0000002a
2d1b1b1b1c001a1b1b1b1b1c000000000000002a
2b2b2b2b2c002a2b2b2b2b2d1b1b1b1b1b1b1b2e
3b3b3b3b3c003a3b3b3b1e1d3b1e2b2b2b2b2b2b
000000000000000000002a2c002a2b2b2b2b2b2b
1b1b1b1b1c001a1b1b1b2e2c002a2b2b2b2b2b2b
2b2b2b2b2c003a3b3b3b3b3c003a3b3b3b3b3b1e
2b2b2b2b2c00000000000000000000000000002a
2b2b2b2b2d1b1b1b1b1b1b1b1b1b1b1b1b1b1b2e
tilesheet caves
song seven_circles
dark
indoors
neighborw 35
sprite 8 3 rat 0 0 0
sprite 9 10 rat 0 0 0
door 17 2 39 17 2
buried_treasure 1 3 0 item:MATCH
