2b2b2b2b2b2b2b2b2b2b2b2b2b2b2b1d3b3b3b1e
2b2b2b2b2b2b2b2b2b2b2b2b2b2b2b2c0000002a
2b2b2b2b2b2b2b2b2b2b2b2b1d3b3b3c0002002a
2b2b2b2b2b2b2b2b2b2b2b2b2c0000000000002a
3b3b3b1e2b2b2b2b2b1d3b3b3c001a1b1b1b1b2e
0000003a3b1e2b1d3b3c000000003a3b3b3b3b1e
00000000003a3b3c00000000151616161616172a
000000000000000000000015292626262626272a
1b1b1c000000000000000035192626262626272a
2b2b2d1b1c000000001a1b1c353619261836372a
2b2b2b2b2d1b1b1b1b2e2b2d1b1c3536371a1b2e
2b2b2b2b2b2b2b2b2b2b2b2b2b2d1b1b1b2e2b2b
tilesheet caves
song seven_circles
flags dark indoors
door 17 2 38 17 2
sprite 6 7 rat 0 0 0
neighborw 40
buried_treasure 8 9 0 item:MATCH
