2626262626262626262626262626262626262626
2626262626262626262626262626262626262626
2626262626262626262626262626262626262626
2626262626262618363636192626262626262626
2626262626261837000100351926262626262626
2626262626262702010302002526262626262626
2626262626262702000003012526262626262626
2626262626262700000001022526262626262626
2626262626262817030101152926262626262626
2626262626262628161616292626262626262626
2626262626262626262626262626262626262626
2626262626262626262626262626262626262626
tilesheet beach
neighbore 42
flags blowback ancillary
neighborn 44
buried_treasure 9 6 0 item:HAT
