2b2b2b2b2b2b2b2b2b2b2b2b2b2b2b2b2b2b2b2b
2b2b2b2b2b2b2b2b2b2b2b2b2b2b2b2b2b2b2b2b
3b1e2b2b2b2b2b2b2b2b2b2b2b2b2b2b2b2b2b2b
173a3b3b1e2b2b2b2b2b2b2b2b2b2b2b2b2b2b2b
281616173a3b3b1e2b2b2b2b2b2b2b2b2b2b2b2b
262626281616173a3b3b3b1e2b2b2b2b2b2b2b2b
26262626262628161616173a3b3b1e2b2b2b2b2b
26262626262626262626281616173a3b3b1e2b2b
26262626262626262626262626281616173a1e2b
2626262626262626262626262626262628172a2b
2626262626262626262626262626262626272a2b
2626262626262626262626262626262626272a2b
tilesheet beach
flags blowback ancillary
neighbors 44
neighbore 25
neighborn 46
