5555476565656565656620222a2b0d0e1f5f2526
5547664f1b1a1c1b1c0020223a3b1d1e2f6f3519
5556435f1f0d0e2b2c0020224300000000101225
6566536f2f1d1e3b3c0020225300000000202225
0000530000000000000020226071717210242225
0000530000000000430020231200101124133225
0000530000000000530030142311241331321529
0000607171717171620000202121133200152926
0000001011111111111111242121221516292626
1616173031313131313131313131322526262626
2626281616161616161616161616162926262626
2626262626262626262626262626262626262626
tilesheet village
song snowglobe
neighborw 2
neighbore 6
neighborn 8
neighbors 13
sprite 4 3 farmer 3 0 0
door 4 3 27 9 9
sprite 14 2 cow 0 0 0
door 16 1 28 10 9
sprite 1 8 tolltroll 0 1 0
saveto spell:TELE1
