6161616161616161616161616161616161616161
6161616161616161616155566161616161616161
6161615371717184857165667186877171546161
6161616200000000000075760000000000606161
7171717200000000000000000000000000606161
0000000000000000000000000000000000606161
0000000000000000000000000000000000606161
5151515200000000000000000000000000606161
6161616200000000000000000000000000606161
6161616351515151515151515151515151646161
6161616161616161616161616161616161616161
6161616161616161616161616161616161616161
tilesheet caves
flags dark indoors
neighborw 49
