2626262618363636363619262626262700252626
2626261837000000000035363636192700252626
1836363700000000000000444546353700351926
2744454545460000000000545556000000002526
2754555555574600000044584766000000002526
2764485555555745454558476600000000002526
2817545555555547656565660000000000002526
2627644855554766000000000000000000152926
2628176465485600000000000000000015292626
2626281617646600000000000000151629262626
2626262628161616161616161616292626262626
2626262626262626262626262626262626262626
tilesheet village
song snowglobe
neighborw 5
neighborn 7
neighbors 18
neighbore 57
sprite 8 2 treasure item:SNOWGLOBE 0 0
sprite 9 8 pushblock 0 0 0
sprite 12 8 pushblock 0 0 0
