2b2b2b2b2b2b2b2b2b2b2b2b2b2b2b2b2b2b2b2b
2b2b2b2b2b2b2b2b2b2b2b2b2b2b2b2b2b2b2b2b
2b2b1db0b1b2b3b4b5b6b7b8b9babbbcbd1e2b2b
2b1d3c00000000000000000000000000003a1e2b
2b2c000000000000000000000000000000002a2b
2b2c001a1b1b1b1b1b1b1b1b1b1b1b1b1c002a2b
2b2c003abebfc0c1c2c3c4c5c6c7c8c93c002a2b
2b2c000000000000000000000000000000002a2b
2b2d1b1c0000000000000000000000001a1b2e2b
2b2b2b2d1b1b1b1b1b1011121b1b1b1b2e2b2b2b
2b2b2b2b2b2b2b2b2b2021222b2b2b2b2b2b2b2b
2b2b2b2b2b2b2b2b2b2b2b2b2b2b2b2b2b2b2b2b
tilesheet caves
song seven_circles
door 10 9 10 2 1
