1836363636363636363636363636363636363636
271a1b1c1b1a1c00000059000000004f1b1a1b1c
272a2b2c1f2a2c0000494a4b0000005f1f2a2b2c
273a3b3c2f3a3c00444545454545466f2f3a3b3c
2700000000000000545555475a5b660000001516
2700000000000044584765666a6b6c0000003519
2700000000000054555600007a7b000000000035
2770717200707264656600000000000000000000
2700000000000000000000000000000000000000
3700000000000000000000000000000000000000
4545454545454545454610120000000000000015
5555555555555555555620221a1b1b1b1b1c1529
tilesheet village
song snowglobe
neighbore 7
neighbors 5
neighborw 4
door 16 3 29 7 9
door 4 3 30 9 9
transmogrify 10 2 from 1
sprite 14 5 pamcake 0 0 0
saveto spell:TELE1
