2113313114220400002a2b2b1d3b3b3b3b3b3b3b
21223fe130320402003a1e2b2c01010000030100
212200000000030103002a2b2d1b1b1b1b1b1b1b
313201000200010001003a3b3b1e2b2b1d3b3b3b
000101010001010000007374752a2b1d3c000003
010303000300010200018384852a1d3ce3000000
040001010000010002019394953a3c0400000200
0102010002000102010001000000010002000001
0300020201010102010002030000010000030015
1112e20000000301000000010001000300001529
212312e400000001000000010015161616162926
2121231200000000010100020025262626262626
tilesheet midlands
song toil_and_trouble
sprite 13 1 3 item:FEATHER 0 0
neighborn 2
door 2 1 3 2 1
neighbore 13
neighbors 19
neighborw 23
hero 11 6
sprite 15 11 34 0 0 0
