2121212121212121212121222a2b2b2b2b2b2b2b
21133131311f3131313114222a2b2b2b2b2b2b2b
1332000100030000000130322a1d3b3b2f3b3b3b
2204000200000002000303002a2c000000010000
2204000101030000000201023a3c010000020001
3200010000000000000201010201000001000200
1702030200000000040001010100000301020001
2703000000000001000000000100000200040015
2703013f00010201020002000100000002000125
2700000301020101010001000000020100000025
2817000000000100030000000000010001021529
2628161616161616161616161616161616162926
tilesheet 1
neighbore 2
neighbors 8
neighborw 9
door 5 1 9 13 5
door 3 8 5 9 5
door 16 2 11 3 3
neighborn 13
sprite 3 3 1 0 0 0
sprite 14 5 1 0 0 0
sprite 7 8 1 0 0 0
