4240414240414240414240414240414240414240
5250515250515250515250515250515250515250
1200000000010300000000000003000000101111
2200020000000100030001000000010000202121
2200000000020000010003010002000203301421
2200000001000000000100000300000201013031
2200000002010202010000001011120000000202
2200010000000001020100012021231200030001
2201000002010000010000102421212311111111
2311120101000000010110242121212121212121
2121220001010001101124212121212121212121
2121231111111111242121212121212121212121
tilesheet mountains
song seven_circles
neighbore 9
neighbors 26
sprite 5 5 treasure item:CHALK 0 0
