2121133131313131142121212121212121212121
2121220001040300303131311421212121212121
1331320000010300000000003031313114212121
2200000000000100030001000000010030313131
2200000000020000010003010002000201020100
2200000001000000000100030100010001011011
2200000002010202010000010100000110112421
2200010000000001020100000100101124212121
2201000002010000010000021011242121212121
2311120101000000010110112421212121212121
2121220001010001101124212121212121212121
2121231111111111242121212121212121212121
tilesheet mountains
song seven_circles
neighbore 9
neighborn 11
neighbors 26
sprite 5 5 treasure item:CHALK 0 0
