797a3a3b3b3b3b3b3b3b3b3b3b3b3b3b1e2b2b2b
898a01030100020000000003010000003a1e2b2b
696a0001000000030001000001010202003a1e2b
797a000002010401020000000000000202022a2b
898a000100020101000001010404020001002a2b
0000010002000000000302000000000100022a2b
0000000000000100040101000100020003002a2b
0002000000000001000001000201000002002a2b
1c04010100010001020000010300000104022a2b
2d1b1c00000000000004020100010001011a2e2b
2b2b2d1c00010004000004010102001a1b2e2b2b
2b2b2b2d1b1b1b1b1b1b1b1b1b1b1b2e2b2b2b2b
tilesheet 1
neighborw 2
sprite 5 2 3 2 0 0
sprite 7 2 3 3 0 0
sprite 9 2 3 4 0 0
sprite 11 2 3 5 0 0
sprite 13 2 3 6 0 0
sprite 15 2 3 7 0 0
sprite 15 4 3 8 0 0
sprite 15 6 3 9 0 0
sprite 15 8 3 10 0 0
sprite 13 9 3 11 0 0
sprite 11 9 3 12 0 0
sprite 9 9 3 13 0 0
sprite 7 9 3 14 0 0
sprite 5 9 3 15 0 0
song 1
