4a48494a48494a48494a48494a48494a48494a48
5a58595a58595a58595a58595a58595a58595a5b
1b1b1b1b1b1c3d0000000000000000010001006b
2b2b2b2b2b2c000144450100000002634445017b
2b1d3b2f3b3c000254550100000001025455008b
2b2c04010002640100530068696a01010101006b
2b2c00430001000103000078797a01000065017b
2b2c00010202010004000088898a00000100028b
2b2d1b1b1b1b1c6300000000006401000200036b
2b2b2b2b2b2b2c0301650000020000000102007b
2b2b2b2b2b2b2c010000001a1b1c01000000008b
2b2b2b2b2b2b2c000100002a2b2c00000001006b
tilesheet 1
neighbors 2
door 3 4 1 16 2
neighborw 13
song eye_of_newt
