2b2b2b2b2b2b2b2b2b2b2b2b2c000100003e027b
2b2b2b2b2b2b1d3b3b3b3b3b3c000000003d008b
2b2b2b2b2b1d3c00010000a0a1a20000023e036b
2b2b2b2b2b2c0001444501b0b1b24445003d007b
2b1d3b2f3b3c000254550193949554550000008b
2b2c04010002640100530068696a01000200026b
2b2c00430001000103000078797a01000065017b
2b2c00010202010004000088898a00000100028b
2b2d1b1b1b1b1c6300000000006401000200036b
2b2b2b2b2b2b2c0301650000020000000102007b
2b2b2b2b2b2b2c010000001a1b1c01000000008b
2b2b2b2b2b2b2c000100002a2b2c00000001006b
tilesheet 1
neighbors 2
door 3 4 1 16 2
neighborw 13
song eye_of_newt
hero 12 4
sprite 17 4 19 1 2 0
neighborn 25
