9091929391919697919191949591919791919191
9191919191919191909790909790909090909291
9791a0a5a6a1a2a3a4a5a6a1a2a3a4a5a6a79291
9191b0b1b1b1b1b1b1b1b1b1b1b1b1b1b1b79092
9191c0b1b1b1b1b1b1b1b1b1b1b1b1b1b1c79091
9791d0b1b1b1b1b1b1b1b1b1b1b1b1b1b1c79097
9297b0b1b1b1b1b1b1b1b1b1b1b1b1b1b1d79791
9190c0b1b1b1b1b1b1b1b1b1b1b1b1b1b1b79291
9797d0b1b1b1b1b1b1b1b1b1b1b1b1b1b1c79091
9192e0e1e1e1e1e1e1e1e1e1e1e1e1e1e1e79792
9291f0f1f1f1f1f1f1f1f1f1f1f1f1f1f1f79291
919292f1f1f1f1f1f1f1f1f1f1f1f1f1f1929191
tilesheet castleext
song jaws_of_wrath
indoors
sprite 11 6 werewolf 0 0 0
