1331313131313131313131313131313131313131
2201040002010300000002020100030201020100
2203010001000000030000000101020100020001
2200010000000100000000010000000201000101
2201010000020001000001010103000100020200
2201000101010001000300010401010000000000
2202000000000002010201010101000101020200
2200000101020204030002000001020000010101
2200000100000100000100040000000001000102
2203000003000000000100010104000000020202
2200000001000000010100010401000200040002
2201000000000002030000000002040101000400
tilesheet mountains
song seven_circles
neighbors 10
neighbore 12
sprite 6 4 treasure item:COMPASS 0 0
