4142404142404142404142404142404142404142
5152505152505152505152505152505152505152
1203010001000000030000000101020100020001
2200010000000100000000010000000201000101
2201010000020001000001010103000100020200
2201000101010001000300010401010000000000
2202000000000002010201010101000101020200
2200000101020204030002000001020000010101
2200000100000100000100040000000001000102
2203000003000000000100010000000100030200
2200030000020102000101021011111111111111
2311111111111111111111112421212121212121
tilesheet mountains
song seven_circles
neighbors 10
neighbore 12
sprite 6 4 treasure item:COMPASS 0 0
