2b2b2b2b2b2b2b2b2b2b2b2b2b2b2b2b2b2b2b2b
2b2b2b2b2b2b1d3b3b3b3b3b3b3b3b3b3b1e2b2b
2b2b2b2b2b1d3c020103000000000001022a2b2b
2b1d3b2f3b3c00000000000000000000032a2b2b
2b2c0102000204000000000000000000032a2b2b
2b2c0000010001000000000001000000002a2b2b
2b2c0000020002030000011a1b1c0000022a2b2b
2b2c01021a1b1c000000022a2b2c0000012a2b2b
2b2d1b1b2e2b2c000000002a2b2c0000012a2b2b
2b2b2b2b2b2b2c040200012a2b2c0000002a2b2b
2b2b2b2b2b2b2c010000022a2b2c0400002a2b2b
2b2b2b2b2b2b2c000100002a2b2c0000042a2b2b
tilesheet 1
neighbors 2
door 3 3 1 16 2
neighborw 13
song eye_of_newt
