4142404142404142404142404142406042404142
5152505152505152505152505152507052505152
1111111111111112010302020402040000020200
2121212121212122000000000000000000000000
2121212121212122000000000000000000000000
2121212121212122040000000000000000000000
2121212121212122010001020001010101000000
2121212121212122000000101111111111111111
2121212121212122000002202121212121212121
2121212121212122000002202121212121212121
2121212121212122010000202121212121212121
2121212121212122000000202121212121212121
tilesheet 1
neighbors 9
neighbore 13
song 2
door 15 1 14 10 10
