404142404142404142404142402a2b2b2b2b2b2b
505152505152505152505152502a2b2b2b2b2b2b
040101010101000000020000003a1e2b2b2b2b2b
03000001000100020001010003013a1e2b2b2b2b
0001000200020104000400000203012a2b2b2b2b
0002020002010100030402010000002a2b2b2b2b
0000030201000000000001010103003a1e2b2b2b
010002020001000000010000030115173a1e2b2b
00010100020000010102040302002528173a1e2b
0000000002000100020100010000252628173a3b
1111111111120110111111111112252626281616
2121212121220020212121212122252626262626
tilesheet mountains
song seven_circles
neighborw 11
neighbors 9
neighbore 4
sprite 15 9 seamonster 0 0 0
