4142404142404142404142404142406042404142
5152505152505152505152505152507052505152
1111111111111111111112000102040000020200
2121212121212121211332010200000000030101
2121212121212113313201000000000000001011
2121212121212122020401000000001011112421
2121212121212122010001020001032021212121
2121212121212122000000101111112421212121
2121212121212122000002202121212121212121
2121212121212122000002202121212121212121
2121212121212122010000202121212121212121
2121212121212122000000202121212121212121
tilesheet 1
neighbors 9
neighbore 13
song 2
door 15 1 14 10 10
wind W
