313131313131313131313131322a2b2b2b2b2b2b
020300020000020201010201012a2b2b2b2b2b2b
040101010101000000020000003a1e2b2b2b2b2b
03000001000100020001010003013a1e2b2b2b2b
0001000200020104000400000203012a2b2b2b2b
0002020002010100030402010000002a2b2b2b2b
0000030201000000000001010103003a1e2b2b2b
010002020001000000010000030115173a1e2b2b
00010100020000010102040302002528173a1e2b
0101000102010104000002000102252628173a3b
0200020301000402000000030000252626281616
0000000000000000000000010000252626262626
tilesheet mountains
song seven_circles
neighborw 11
neighbors 9
neighbore 4
sprite 15 9 seamonster 0 0 0
