2121212121212121212121222a2b2b2b2b2b2b2b
3131313131313131313131322a2b2b2b2b2b2b2b
0000000200030300000100002a2b2b2b2b2b2b2b
0000000000000000000000002a2b2b2b2b2b2b2b
0000000000000000000000022a2b2b2b2b2b2b2b
0000000000000000000000002a2b2b2b2b2b2b2b
0100000001000001010001012a2b2b2b2b2b2b2b
1111111111111111111111122a2b2b2b2b2b2b2b
2121212121212121212121222a2b2b2b2b2b2b2b
2121212121212121212121222a2b2b2b2b2b2b2b
2121212121212121212121222a2b2b2b2b2b2b2b
2121212121212121212121222a2b2b2b2b2b2b2b
tilesheet 1
neighborw 12
neighbors 1
neighbore 11
