2b2b2b1d3b3b3c00003a3b3b3b3b3b1e2b2b2b2b
2b2b1d3c00000000000000000000003a1e2b2b2b
3b3b3c000000001a1c000000000000003a1e2b2b
0000000000001a2e2d1c003e003e0000003a1e2b
1b1b1c0000003a1e1d3c00000000000000003a3b
2b2b2d1c0000003a3c000000001a1c0000000000
2b2b1d3c00000000000000001a2e2d1c00000000
2b1d3c0000000000000000003a3b3b3c00001a1b
2b2c0000003d0000003d00000000000000002a2b
2b2c0000000000001a1c001a1c00000000002a2b
2b2d1b1b1b1b1b1b2e2c002a2d1b1b1b1b1b2e2b
2b2b2b2b2b2b2b2b2b2d1b2e2b2b2b2b2b2b2b2b
tilesheet caves
door 10 10 12 15 1
neighborw 15
neighbore 16
neighborn 17
