2b2b2b2b2b2b2b2b2b2c00002a2b2b2b2b2b2b2b
2b2b2b2b1d3b3b3b3b3c00003a3b3b3b1e2b2b2b
2b2b2b1d3c00000000000000000000003a3b3b3b
2b2b1d3c00000000151616161617000000000000
2b2b2c000015161629261836363700000000001a
2b1d3c000025183636363700000000000000002a
2b2c000000353700000000001516170000001a2e
2b2c0000000000001516161629183700001a2e2b
2b2c00003e00000035363636363700001a2e2b2b
2b2d1c0000000000000000000000001a2e2b2b2b
2b2b2d1b1b1b1b1b1b1b1b1b1b1b1b2e2b2b2b2b
2b2b2b2b2b2b2b2b2b2b2b2b2b2b2b2b2b2b2b2b
tilesheet caves
neighbore 14
dark
neighborn 18
