2627010100013a3b3b3b3b3b3b1e2b2b2b2b2b2b
262701000001010003000100013a3b1e2b2b2b2b
2627010101030001000000000101003a3b1e2b2b
26270100020001000000010102000000003a3b1e
262817020101000100030004000100020003003a
2626270101020000000102010001000000010400
2626270100020100020101000000000000000103
2626281700000401000100010000001a1b1c0102
2626262700000003020000000001003a1e2d1b1b
262626281700020000000100000300002a2b2b2b
262626262816161616161616170000003a3b3b3b
2626262626262626262626262816161616161616
tilesheet forest
song toil_and_trouble
neighborn 14
neighbore 16
neighborw 20
sprite 1 6 seamonster 0 0 0
neighbors 63
