2b2b2b2b2b2b2b2b2b2c00002a2b2b2b2b2b2b2b
2b2b2b2b1d3b3b3b3b3c00003a3b3b3b1e2b2b2b
2b2b2b1d3c00000000000000000000003a3b3b3b
2b2b1d3c000000001a1b1b1b1b1c000000000000
2b2b2c00001a1b1b2e2b1d3b3b3c00000000001a
2b1d3c00002a1d3b3b3b3c00000000000000002a
2b2c0000003a3c00000000001a1b1c0000001a2e
2b2c0000000000001a1b1b1b2e1d3c00001a2e2b
2b2c00003e0000003a3b3b3b3b3c00001a2e2b2b
2b2d1c0000000000000000000000001a2e2b2b2b
2b2b2d1b1b1b1b1b1b1b1b1b1b1b1b2e2b2b2b2b
2b2b2b2b2b2b2b2b2b2b2b2b2b2b2b2b2b2b2b2b
tilesheet caves
neighbore 14
dark
neighborn 18
