2225270100013a3b1e2b2b2b2b2b2b2b2b2b2b2b
22252700000101003a3b3b1e2b2b2b2b2b2b2b2b
32252703010300010401032a2b2b2b2b2b2b2b2b
16292700030001000000013a1e2b2b2b2b2b2b2b
2626281701010001000300003a3b1e2b2b2b2b2b
26262627000200000001020202003a1e2b2b2b2b
2626262700000100020101000000002a2b2b2b2b
2626262817010401000100010000002a2b2b2b2b
2626262627000103020000000001003a1e2b2b2b
262626262817000000000100000300002a2b2b2b
262626262628161616161616170000003a3b3b3b
2626262626262626262626262816161616161616
tilesheet forest
song toil_and_trouble
neighborn 14
neighbore 16
neighborw 20
sprite 1 6 seamonster 0 0 0
neighbors 63
