2b2b2b2b2b2b2b2b1d3b3b3b3b1e2b2b2b2b2b2b
2b2b2b2b2b1d3b3b3c000000003a3b3b1e2b2b2b
2b2b2b1d3b3c000000001a1c000000003a1e2b2b
2b2b1d3c0000000000002a2c00000000002a2b2b
3b3b3c000000001a1b1b2e2d1b1b1c00003a1e2b
000000001a1b1b2e2b2b2b2b2b2b2c0000002a2b
000000003a3b3b3b3b1e2b2b2b2b2c003e002a2b
1b1c000000000000002a2b2b2b1d3c0000002a2b
2b2d1b1c00000000003a3b3b3b3c0000001a2e2b
2b2b2b2d1b1b1b1c000000000000001a1b2e2b2b
2b2b2b2b2b2b2b2d1b1b1011121b1b2e2b2b2b2b
2b2b2b2b2b2b2b2b2b2b2021222b2b2b2b2b2b2b
tilesheet caves
neighborw 14
door 11 10 13 7 1
