2b2b2b2b2b2b2b2b2b2b2b2b2b2b2b2b2b2b2b2b
2b2b2b2b2b2b2b2b2b2b2b2b2b2b2b2b2b2b2b2b
2b2b2b2b2b2b2b2b2b2b2b2b2b2b2b2b2b2b2b2b
2b2b2b2b2b2b2b2b2b2b2b2b2b2b2b2b2b2b2b2b
2b2b2b2b2b2b2b2b2b2b2b2b2b2b2b2b2b2b2b2b
2b2b2b2b2b2b2b2b2b2b2b2b2b2b2b2b2b2b2b2b
2b2b2b2b2b2b2b2b2b2b2b2b2b2b2b2b2b2b2b2b
2b2b2b2b2b2b2b2b2b2b2b2b2b2b2b2b2b1d3b3b
2b2b2b2b2b2b2b2b2b2b2b2b2b2b1d3b3b3c1516
2b2b2b2b2b2b2b2b2b2b2b1d3b3b3c1516162926
3b3b3b3b3b3b3b3b3b3b3b3c1516162926262626
1616161616161616161616162926262626262626
tilesheet forest
song toil_and_trouble
neighborw 15
neighborn 17
neighbore 60
neighbors 62
