2b2b2b2b2b2c0300020001003a3b1e2b2b2b2b2b
2b2b2b2b1d3c01000001010102013a3b1e2b2b2b
2b2b2b1d3c00030101010002000200003a1e2b2b
3b3b3b3c030000030000000001010003002a2b2b
00020301010100000000030100000002002a2b2b
010000000201000001000002000401031a2e2b2b
1b1b1b1b1b1c030000020001010001012a2b2b2b
2b2b2b2b2b2d1c0201000202010301002a2b2b2b
2b2b2b2b2b2b2c0000000000000001002a2b2b2b
2b2b2b2b2b2b2d1c01000000001a1b1b2e2b2b2b
2b2b2b2b2b2b2b2c0003001a1b2e2b2b2b2b2b2b
2b2b2b2b2b2b2b2c0001002a2b2b2b2b2b2b2b2b
tilesheet forest
song toil_and_trouble
neighbors 16
neighborw 14
neighborn 18
