2b2b2b1d3b3b3b3b3b1e2b2b1d3b3b3b1e2b2b2b
2b2b1d3c00000000003a1e2b2c0000003a1e2b2b
2b1d3c000000000000002a1d3c000000003a1e2b
2b2c00001a1b1b1c00002a2c0000000000002a2b
2b2c00003a3b1e2c00003a3c00001a1c00002a2b
2b2c000000002a2c0000000000002a2c00003a1e
2b2c000000002a2c0000000000002a2c0000002a
2b2c0000001a2e2d1b1b1b1c00002a2c0000002a
2b2d1c00003a3b3b3b3b1e2d1b1b2e2c0000002a
2b2b2d1c0000000000003a3b3b3b3b3c00001a2e
2b2b2b2d1b1b1c000000000000000000001a2e2b
2b2b2b2b2b2b2c00001a1b1b1b1b1b1b1b2e2b2b
tilesheet caves
neighbors 14
