2b1d3b3b3b3b3b1e2b2b2b2b2b2b2b2b2b2b2b2b
1d3c00010200013a3b1e2b2b2b2b2b2b2b2b2b2b
3c00000200010000003a3b3b3b1e2b2b2b2b2b2b
000001000002020100000002013a3b1e2b2b2b2b
1b1c000001000400000200000000033a1e2b2b2b
3b3c01030000010002000100000000003a1e2b2b
00000000000301000101000000000100012a2b2b
00010003000000000000000201020000003a1e2b
0000000000000000010101000003000001022a2b
0004010101000300000202000000000000032a2b
04020300010004030000010000010000001a2e2b
1b1b1b1b1b1c0100000001001a1b1b1b1b2e2b2b
tilesheet forest
song toil_and_trouble
neighbors 17
neighborw 13
neighborn 6
sprite 9 4 20 0 0 0
sprite 13 7 20 0 0 0
