1d3b3b3b1e1d3b3b3b3b1e1d3b3b3b3b3b3b3b1e
2c0000002a2c000000002a2c000000000000002a
2c0000002a2c000000002a2d1b1c001a1c00002a
2c0000002a2c000000002a2b2b2c002a2c00002a
2c0000002a2d1b1b1c002a2b2b2c002a2c00003a
2c0000003a3b3b3b3c003a3b3b3c002a2c000000
2c00000000000000000000000000002a2c000000
2c0000001a1b1b1b1b1b1b1b1b1b1b2e2c00001a
2c0000003a3b3b3b3b3b3b3b3b3b3b3b3c00002a
2c0000000000000000000000000000000000002a
2c0000000000000000000000000000000000002a
2d1b1b1b1b1b1b1b1b1c00001a1b1b1b1b1b1b2e
tilesheet caves
neighbors 15
neighbore 17
dark
