2121210b0c0c0c0c0d3636192626262626262626
1331313203000001030101353619262626262626
321a1c0303010001030000010235192626262626
1b2e2d1c00000202000003010300351926262626
2b2b1d3c0300013e020003020101032526262626
2b1d3c020103020301023d020101022526262626
2b2c020301020203020303020100032526262626
2b2c020100000100020201000303012526262626
2b2d1c00010302013e0101010000002526262626
2b2b2c0303000003020300000100002526262626
2b2b2c0202000101010000000101152926262626
2b2b2c0103000000000100011516292626262626
tilesheet beach
song eye_of_newt
neighborn 1
neighbore 14
neighbors 20
neighborw 24
sprite 17 4 seamonster 0 0 0
