2121212203000000000101030025262626262626
2121133201020102030100000025262626262626
2121220301010001030002040035192626262626
2113320000000000000000000000351926262626
1332000101000000000000040100012526262626
2200030000000101010104000001002526262626
2201020100030300010300000002042526262626
2201040000000000000100010300002526262626
2200000000010202000001010000002526262626
2201000103000002000100000100002526262626
2312010002000101010000000101152926262626
2122000103000000000100011516292626262626
tilesheet beach
song eye_of_newt
neighborn 1
neighbore 14
neighbors 20
neighborw 24
sprite 17 4 seamonster 0 0 0
