2121210b0c0c0c0c0d3636192618372021212121
1331313202020303464748353637102413313131
321a1c0103020101010000030002303132151616
1b2e2c0003020202000003010301031516292626
2b1d3c000003033e030100000101032526262626
2b2c0809090909090909090909090a2526262626
2b2c02000100030303033e020000002526262626
2b2c0809090909090909090909090a2526262626
2b2d1c03010003003d0303020201012526262626
2b2b2c0303000003020300000100002526262626
2b2b2c0202000101010000030202152926262626
2b2b2c0103000000000100020203252626262626
tilesheet beach
song eye_of_newt
neighborn 1
neighbore 14
neighbors 20
neighborw 24
sprite 17 4 seamonster 0xc5 0 0
sprite 9 1 scoreboard 1 0 0
sprite 5 5 saw 0 0 0
sprite 10 7 saw 0 0 0
