2121210b0c0c0c0c0d3636192618373014212121
1331313202020303464748353637000130313114
321a1c0103020101010000030001000015161720
1b2e2c0003020202000003010303151629262720
2b1d3c000003033e030100000103252626262720
2b2c08090909090909090909090a252626262720
2b2c02000100030303033e020003252626262720
2b2c08090909090909090909090a252626262720
2b2d1c03010003003d0303020202252626262720
2b2b2c0303000003020302000103252626183720
2b2b2c0202000101010001010302252626271024
2b2b2c0103000000000100000100252626272021
tilesheet beach
song eye_of_newt
neighborn 1
neighbore 14
neighbors 20
neighborw 24
sprite 17 4 seamonster 0xc5 0 0
sprite 9 1 scoreboard 1 0 0
sprite 5 5 saw 0 0 0
sprite 10 7 saw 0 0 0
sprite 14 1 panda 0 0 0
