0202020202020202020202020202020202020202
0202020202020202020202020202020202020202
0202020202020202020202020202020202020202
0202020202122121212121212121100202020202
0202020202123131313131313131100202020202
0202020202120000000000000000100202020202
0202020202120000000000000000100202020202
0202020202120000000000000000100202020202
0202020202212121212121012121210202020202
0202020202313131313131313131310202020202
0202020202020202020202020202020202020202
0202020202020202020202020202020202020202
tilesheet villint
door 11 8 5 3 3
sprite 7 6 24 3 0 0
