1d3b3b3b3b3b3c010000013a3b3c0000003a3b1e
2c0000000000000400000001000001000002012a
3c0100000000000000000000000000000000002a
010000000000000000000000000000000000023a
0000000000000000000000000000000000000100
0000000000000000000000000000000000000000
0000000000000000000000000000000000000000
1701000000000000000000000000000000000002
2700000000000000000000000000000000000215
2700000000000000000000000000000000000025
2700000401000002000000000000010000000425
2816161616161700000000000315161616161629
tilesheet 1
neighborw 1
neighbors 3
neighbore 10
neighborn 11
