3c25262626262626260726262626262626262626
1629262626262626260726262626262626262626
2626262626261836360736361926262626262626
363636363636373d010100e73536363636363636
0000020300020809090909090a00000200010000
0002000300020001000100010000010401010000
0004020101000000020000010001030002030302
0002010100000201000000000200000000000400
0102030400000001010002010300000300000002
111112e501000000020001010000000000000001
21212311111201000200010001010000e61a1b1b
2121212121220100011a1b1b1b1b1b1b1b2e2b2b
tilesheet midlands
song toil_and_trouble
neighbors 1
neighborn 4
neighbore 5
neighborw 9
sprite 13 1 seamonster 0 0 0
sprite 9 1 pushblock 0 0 0
sprite 8 4 saw 0 0 0
sprite 7 3 firenozzle_e 3 30 0
