2b2b2b1d3b3b3c010000022a2b2c0000003a3b1e
2b2b2b2c010000040001042a2b2c02000002012a
3b3b1e2c0200000000001a2e1d3c01000000002a
02003a3c0000000000023a3b3c0001000000023a
0001010200000000000200000000000000000100
0000000000000000000000000000000000000000
0000000000000000000000000000000000000000
1701000000000000000000000000000000000002
2700000000000000000000000000000000000215
2700000000000000000000000000000000000025
2700000401000002000000000000010000000425
2816161616161700000000000315161616161629
tilesheet 1
neighborw 1
neighbors 3
neighbore 10
neighborn 11
sprite 4 3 2 0 0 0
sprite 6 3 2 0 0 0
sprite 5 3 2 0 0 0
sprite 9 3 2 0 0 0
sprite 7 3 2 0 0 0
sprite 8 5 2 0 0 0
sprite 8 3 2 0 0 0
sprite 9 5 2 0 0 0
song toil_and_trouble
