2b2b2b1d3b3b3c010000022a2b2c00000100007b
2b2b2b2c010000040000002a2b2c02000100008b
3b3b1e2c020000000000003a3b3c01020000006b
02003a3c0000000000020004000000616200027b
0001010002000200000168696a0001030002018b
0000000002030000000278797a00010100040000
00000168696a0000000488898a00024445010000
17010178797a0000010101000101005455000100
27000188898a000001010300650003010000021a
270064000000000002030000000100010000002a
370001000101010000000000030001010200032a
1b1b1b1b1b1b1c0101000001001a1b1b1b1b1b2e
tilesheet 1
neighborw 1
neighbors 3
neighbore 10
neighborn 11
sprite 4 3 2 0 0 0
sprite 6 3 2 0 0 0
sprite 5 3 2 0 0 0
sprite 7 5 2 0 0 0
sprite 7 3 2 0 0 0
sprite 8 5 2 0 0 0
sprite 8 3 2 0 0 0
sprite 9 5 2 0 0 0
song toil_and_trouble
sprite 9 8 21 0 0 0
sprite 15 4 21 0 0 0
