2b2b2b1d3b3b3c010000022a2b2c00000100007b
2b2b2b2c010000040000002a2b2c02000100008b
3b3b1e2c020000000000003a3b3c01000101006b
02003a3c0000000000020004000001030401027b
0001010002000200000168696a0000000300018b
0000000002030000000278797a00010100040000
00000168696a0000000488898a00024445010000
17010178797a0000010101000101005455000002
27000188898a0000010103006500030100000215
2700640000000000020300000001000100000025
2700000401000002000000000000010000000425
2816161616161700010000010215161616161629
tilesheet 1
neighborw 1
neighbors 3
neighbore 10
neighborn 11
sprite 4 3 2 0 0 0
sprite 6 3 2 0 0 0
sprite 5 3 2 0 0 0
sprite 7 5 2 0 0 0
sprite 7 3 2 0 0 0
sprite 8 5 2 0 0 0
sprite 8 3 2 0 0 0
sprite 9 5 2 0 0 0
song toil_and_trouble
