3132000000000001000201002526262626262626
0000000100000201010004002526262626262626
0000010001000100020104003536192626262626
0000030100020001033d3d3e3e3e252626262626
0003020000000101013d0102003e252626262626
00000002000100020100013d013e252626262626
0000000002000001023d3d3d3e3d252618361926
0003000200010000031516161616292627012526
0000151616161616162926262626262627002526
1616292626262626262626262626262627002526
2626262626262626262626262626262628162926
2626262626262626262626262626262626262626
tilesheet beach
song eye_of_newt
neighborn 19
neighbore 15
neighborw 21
sprite 16 3 34 0 0 0
sprite 8 10 34 0 0 0
sprite 17 8 1 0 0 0
sprite 17 7 8 gs:windblockn 0 0
sprite 17 9 8 gs:windblocks 0 0
sprite 9 5 10 gs:windblockn 0 0
sprite 11 4 10 gs:windblocks 0 0
sprite 12 5 3 item:UMBRELLA 0 0
