2b2c000000000000000000000000002526262626
2b2c020000000000000000000000022526262626
2b2c010000000000000000000000002526262626
2b2c010000000000000000000000022526262626
2b2c000000000000000000000000022526262626
2b2c000000000000000000000000032526262626
2b2c000000000000000001000000002526262626
2b2c020000000000000110120010122526262626
2b2c010000010000000020231124222526262626
2b2c010401020400000030313131323536363636
2b2d1b1b1b1b1b1b1b1b1b1b1b1b1b1b1b1b1b1b
2b2b2b2b2b2b2b2b2b2b2b2b2b2b2b2b2b2b2b2b
tilesheet 1
neighbore 7
neighborn 22
hero 12 7
