2b2c000000000000000000000000002526262626
2b2c020000000000000000000000022526262626
2b2c010000000000000000000000002526262626
2b2c010000000000000000000000022526262626
2b2c000000000000000000000000022526262626
2b2c000000000000000000000000032526262626
2b2c000000000000000000000000032526262626
2b2c020000000000000000000000012526262626
2b2c010000010000000000020000012526262626
2b2c010401020400000100020301003536363636
2b2d1b1b1b1b1b1b1b1b1b1b1b1b1b1b1b1b1b1b
2b2b2b2b2b2b2b2b2b2b2b2b2b2b2b2b2b2b2b2b
tilesheet 1
neighbore 7
neighborn 22
