3114212121220400010300000300012021211331
0030142121220200000238040001002021133202
0400301421220015170000021517002013320000
0001013031320125281616162927003032020002
0000030200000125262626262627010400000000
0001020001020125262626262627040100000102
0000020000000035363619261837000000000000
000000000003013d003d2526273d000000020000
0100000000000001030206060600000103000001
0000020000000000020025262701020102151616
0000000000001516161629262816161616292626
1616161616162926262626262626262626262626
tilesheet beach
song eye_of_newt
neighbore 20
neighborw 22
neighborn 24
sprite 10 0 firewall 0 0 0
sprite 11 8 tolltroll 0 0 0
sprite 15 5 lobster 0 0 0
sprite 5 6 lobster 0 0 0
