2b2c000001000000000100000000002526262626
2b2c020333010103010100000100022526262626
2b2c003300010300010134020100002526262626
2b2c030101000000000000330101002526262626
2b2c00340300c0c1c20133000000332526262626
2b2c03023304d0d1d20101330134002526262626
2b2c023300019394950133000002332526262626
2b2c010034010000000000340133012526262626
2b2c033300000000000333020300342526262626
2b2c030002020400010000000100003536363636
2b2d1b1b1b1b1b1b1c01001a1b1b1b1b1b1b1b1b
2b2b2b2b2b2b2b2b2c03002a2b2b2b2b2b2b2b2b
tilesheet 1
neighbore 7
neighborn 22
hero 7 6
neighbors 23
wind N
