2b2b2b2b2b2b2b1d3b3b3b3b3b3b3b3b3b3b3b3b
3b3b3b3b3b3b3b3c404142020201434445010202
1703010003020001505152013e01535455020003
2700000300020300030001010000010201020000
281700000101030000030100030102033d020103
26270201023e0002010200030303020203030201
2628170202030003020101010102010202010303
2626281617000000010301030103010201000003
2626262628161617000000030003010303020301
2626262626262628161616161701000000020100
2626262626262626262626262816170001000300
2626262626262626262626262626281616161616
tilesheet beach
song eye_of_newt
neighbore 21
neighborn 25
sprite 1 8 seamonster 0 0 0
sprite 6 4 lobster 0 0 0
sprite 16 6 lobster 0 0 0
sprite 10 5 alphablock_lambda 0 0 0
