2121212121212122020102000001012021212121
2121212121212122010401010000002021212121
3131142113313132000000000100022021212121
1b1c303132020100000200040201002021212121
2b2d1b1c00000003040300000002032021212121
2b2b2b2c00011a1b1b1b1b1b1b1c013031313131
2b2b2b2c00013a3b3b3b1e2b2b2c011516161616
2b2b2b2c0100020201033a3b1e2c022526262626
2b2b1d3c01010002010000033a3c002526262626
2b1d3c0002000002000200000001022526262626
2b2c000400020100000000000100032526262626
2b2c010000010000020000000000002526262626
tilesheet 1
neighbors 21
neighbore 9
sprite 11 0 18 0 0 0
wind S
