2121212121212121212121212121212121212121
2121212121212121212121212121212121212121
3131142121212121212121212121212121212121
1b1c303114212121212121212121212121212121
2b2d1b1c30311421212121212121212121212121
2b2b2b2d1b1c3031313131313131313131313131
2b2b2b2b2b2c0000010100030100001516161616
2b2b2b1d3b3c0000000000000000002526262626
2b2b1d3c01000200000000000000022526262626
2b1d3c0002000000000000000000002526262626
2b2c000400000000000000000000032526262626
2b2c010000000000000000000000002526262626
tilesheet 1
neighbors 21
neighbore 9
