2121212121212113313131313131313131313131
3131313131313132000402020201000000020100
1700010003000001020001000001020002020003
2700000203020000010102010200010100000000
2817000101000000020004020001000001000100
2627020001000100010201000001000002000000
2628170200000200010100000201000000020100
2626281617000000010102000202040101000203
2626262628161617000004000100010002000004
2626262626262628161616161700000000010100
2626262626262626262626262816170001000300
2626262626262626262626262626281616161616
tilesheet beach
song eye_of_newt
neighbore 21
neighborn 25
sprite 1 8 seamonster 0 0 0
sprite 13 4 treasure item:SHOVEL 0 0
sprite 6 4 lobster 0 0 0
sprite 16 6 lobster 0 0 0
