6262455252525252525252525252525252532021
0000614552524462626262626262624552532021
0000006162626300000000000000006162632021
4800000000000000000000000000000000003031
5947474747474800006400006500000000000000
676767674a575948000000000000000000000000
6f6e6f6f664a5758000000000000000000000000
000000006f565758000000000000000000000000
000000006e565758000000000000000000000000
000000006f565759480000000000000000001011
000000006f565757580000000000000010112421
4d0000006e565757584b4c4c4c4c4c4d20212121
tilesheet desert
song eye_of_newt
neighbore 1
neighborn 9
neighbors 24
neighborw 26
sprite 3 7 treasure item:COMPASS 0 0
