2b2b2b2b2b2b1d3b3c04003a3b1e2b2b2b2b2b2b
3b3b3b3b3b3b3c0000010002003a3b3b3b3b3b3b
00010200010000001a1b1b1c0000010200030101
00000000010304012a2b2b2d1c00010202000200
00000002030001002a2b2b2b2c00040200020000
000001020001031a2e2b2b2b2c01000002000203
000000000000003a1e2b2b2b2c00000200020400
00000002000001012a2b2b2b2c01030301020001
00000000010000002a2b2b1d3c03020000000001
00000102000000003a3b3b3c0103010001030001
1b1b1b1b1b1b1c0002000101021a1b1b1b1b1b1b
2b2b2b2b2b2b2c0200000000002a2b2b2b2b2b2b
tilesheet 1
neighborn 21
neighbore 6
sprite 0 2 18 0 0 0
sprite 19 2 18 0 0 0
neighbors 24
