3131313131313114212121212121212121212121
0202000101000130313131311421212121212121
0001010001000103010102013031311421212121
0004030000000101000401010104003031313131
0003000004020101000301010400020100010101
0001000300000300000400010301010002000103
0100000000000101040101000000020100020000
0001020000000100000003000001020000000000
0001010002010000000000000300010100000002
0101000000010002010103000100000000011011
0000010004010000000000000201000100102421
0000010100010000000101000001000210242121
tilesheet desert
song eye_of_newt
neighbore 1
neighborn 9
neighbors 24
neighborw 26
sprite 8 5 treasure item:BELL 0 0
