6d0000006e565749685b5c5c5c5c5c5d30311421
000000006e564968006b6c6c6c4f5c5e4c4d3031
000000006f56580000000000006b6c6c4f5e4c4c
000000006f56594748000000000000006b6c4f5c
000000006f565757580000000000000000005b5c
0000006e465a57575800000000006f0000005b5c
6f6e6f465a575749680000000000000000005b5c
4747475a49676768000000000000006e00006b4f
57574967680000000000006e000000000000005b
574968000000000000000000000000000000005b
6768000000000000000000000000000000004b5f
4c4c4c4c4c4c4c4c4c4c4c4c4c4c4c4c4c4c5f5c
tilesheet desert
song eye_of_newt
neighborn 23
neighbore 19
neighbors 21
neighborw 25
