0000010000010001000001000001040220212121
0004000201000001000000000101000230142121
0003030003000200000003000001000000202121
0101010002020102000100010200000001301421
0002000100000301010300010300000000002021
0200000301010000000102000100020000012021
0000010100000000040100000001000000002021
0004020201000102000001030000010203003014
0000000001000000000300000000010000000020
0000000003000200020200020301010000010020
0001000101020000000002010100000003001024
1111111111111111111111111111111111112421
tilesheet desert
song eye_of_newt
neighborn 23
neighbore 19
neighbors 21
neighborw 25
