1d3b3b3b3b3b3c0100000000003a3b3b3b3b3b1e
2c0100000100020100000100030000000000022a
2c0100010000010001000202030001000101012a
2c0101010100020104040000020001030100002a
2c0100010100000000000000020102000000012a
2c0000000102030000000000000004000003042a
2c0200000101010003020000000000010001002a
2c0000000000000002000200000101000100002a
2c0002010201010004020002000100000100022a
2c0000000402000200010000020001000101002a
2c0101010300000201000101010000000400002a
2d1b1b1b1b1b1b1b1b1b1b1b1b1b1b1b1b1b1b2e
tilesheet 1
neighborn 23
