5d0000005657575757575757575757586f00006b
5d000000565757496767674a575757586e000000
5d000000664a57586f6e6f76777777786e000000
5e4d000000664a5800006e76777777786f000000
5c5d000000006668000000767777777800000000
5c5d00000000000000006e76777777786e000000
5c5d00000000000000006f76777777786e6e6e6f
5c5e4d000000000000006f565757575947474747
5c5c5d000000000000006e6667674a5757575757
5c5c5d000000000000000000000066674a575757
5c5c5e4d00000000000000000000000066676767
5c5c5c5e4c4c4c4c4c4c4c4c4c4c4c4c4c4c4c4c
tilesheet desert
song eye_of_newt
neighbore 24
neighbors 22
neighborn 26
sprite 6 6 treasure item:BROOM 0 0
neighborw 45
sprite 13 4 trickfloor 0 0 0
