2201010000010000000101020300000002000000
2200000000020001010002000000000001000204
2200000100000400020200000300010200040200
2312000001000202000000030100020000000201
2122010002000000010100020300010300000000
2122000004010200020201010000000100000000
2122010100000100000101040201030000000001
2123120000000000000203020000000000010202
2121220100010000030100000000000102010000
2121231112020300000000000204000100000000
2121212123111111111111120101000001000200
2121212121212121212121231111111111111111
tilesheet desert
song eye_of_newt
neighbore 24
neighbors 22
neighborn 26
sprite 6 6 3 item:BROOM 0 0
