2b2b2b2b2b2b2b2b2b2b2b2b2b2b2b2b2b2b2c7b
1d3b3b3b3b3b3b3b3b3b3b3b3b3b3b3b3b3b3c8b
2c0202000202101112020100010001010000046b
2c0000000000202122000000000000000000007b
2c0200000004202122000000000000000000008b
2c0100000000202122010204010200010000016b
2c0000000001202123111111111111111112007b
2c0400000003202121212121212121212122008b
2c0100000000303131313131313131313132016b
2c010000000100000300000200010100013d037b
2c030300000001000100000300000000013e038b
2d1b1b1b1b1b1b1b1b1b1b1b1c010000003d016b
tilesheet 1
neighbors 11
