5d00000056575757575757586f0000000000006b
5d00000066676767674a57594747480000000000
5d00000000000000005657575757594800000000
5e4d000000000000006667674a57575947480000
5c5d00000000000000000000664a575757594800
5c5d000000000000000000000066674a57575800
5c5d00000000000000000000000000565757586f
5c5e4d000000000000000000000000664a575947
5c5c5d00000000000000000000000000664a5757
5c5c5d0000000000000000000000000000664a57
5c5c5e4d00000000000000000000000000006667
5c5c5c5e4c4c4c4c4c4c4c4c4c4c4c4c4c4c4c4c
tilesheet desert
song eye_of_newt
neighbore 24
neighbors 22
neighborn 26
sprite 6 6 treasure item:BROOM 0 0
