2b2b2b2b2b2b2b2b2b2b2b2b2b2b2b2b2b2b2b2b
2b2b2b2b2b2b2b1d3b3b1e1d3b3b1e2b2b2b2b2b
2b2b2b2b2b2b1d3c00003a3c00002a2b2b2b2b2b
2b2b2b2b2b1d3c000000000000003a1e2b2b2b2b
2b2b2b2b1d3c0000003e00000000003a1e2b2b2b
2b2b2b2b2c00000000000000000000002a2b2b2b
2b2b2b2b2c000000000000003d0000002a2b2b2b
2b2b2b2b2c00001a1c000000000000002a2b2b2b
2b2b2b2b2c00002a2c0000000000001a2e2b2b2b
2b2b2b2b2d1b1b2e2c0000001a1b1b2e2b2b2b2b
2b2b2b2b2b2b2b2b2d1011122e2b2b2b2b2b2b2b
2b2b2b2b2b2b2b2b2b2021222b2b2b2b2b2b2b2b
tilesheet caves
door 10 10 8 17 2
