5252525252525252525252524462626262626262
5252525252525252524462626300000000000000
5252525252524462626300000000000000000000
525252525244630000000000000000006e464747
52525252446300000000000041424346475a5757
52524462630000006e0000415544635657496767
6262630000000000000000616263465a49686f6e
4c4d000000006e000000004647475a49686e0000
5c5d0000000000000000465a575749686f000000
4e6d00000000004647475a575749686e00000000
5d0000000046475a5757575757586f0000000000
5d000000465a57575757575757586e000000004b
tilesheet desert
song eye_of_newt
neighbors 25
neighbore 23
neighborn 10
neighborw 46
