2121212121212121212121211331313131313131
2121212121212121133131313200000000010100
2121212121211331320000030101000100010003
2121212113313201040000000001010001000101
2121211332000101030400000100000404000102
2121133200000103010002040000020000010203
2113320200010102010001000000000402000100
2122010000000003020000010000020000010202
2122000000000200010104020000010100000001
1332010000000000040104010301030300000003
2200000300000000000301000200000002040001
2200040000040100000000000003010001000402
tilesheet desert
song eye_of_newt
neighbors 25
neighbore 23
neighborn 10
