0101010101010101010101010101010101010101
0101010101010101010101010101010101010101
0101010122232323232323232323232201010101
0101010120313131313131313131312001010101
0101010120000000000000000000002001010101
0101010120000000000000000000002001010101
0101010120000000000000000000002001010101
0101010120000000000000000000002001010101
0101010130111111020004111111113001010101
0101010121212121121314212121212101010101
0101010101010101010101010101010101010101
0101010101010101010101010101010101010101
tilesheet villint
indoors
door 9 9 5 4 3
sprite 6 5 treasure item:SHOVEL 0 0
