0202020202020202020202020202020202020202
0212313131313131313131313131313131311002
0212000000000000000000000000000000001002
0212000000000000000000000000000000001002
0212000000000000000000000000000000001002
0212000000000000000000000000000000001002
0212000000000000000000000000000000001002
0212000000000000000000000000000000001002
0212000000000000000000000000000000001002
0212000000000000000000000000000000001002
0221212121212121210121212121212121212102
0202020202020202020202020202020202020202
tilesheet villint
indoors
door 9 10 5 8 3
