0202020202020202020202020202020202020202
0202020202020202020202020202020202020202
0202020223313131313131313131230202020202
0202020223000000000000000000230202020202
0202020223000000000000000000230202020202
0202020223000000000000000000230202020202
0202020223000000000000000000230202020202
0202020223000000000000000000230202020202
0202020221212121212101212121210202020202
0202020202020202020202020202020202020202
0202020202020202020202020202020202020202
0202020202020202020202020202020202020202
tilesheet villint
door 10 8 7 12 3
sprite 7 4 treasure item:PITCHER 0 0
