0202020202020202020202020202020202020202
0202020202020202020202020202020202020202
0202020202020202020202020202020202020202
0202020202143131313131313131311402020202
0202020202140000000000000000001402020202
0202020202140000000000000000001402020202
0202020202140000000000000000001402020202
0202020202140000000000000000001402020202
0202020202212101212121212121212102020202
0202020202020202020202020202020202020202
0202020202020202020202020202020202020202
0202020202020202020202020202020202020202
tilesheet villint
door 7 8 8 16 3
sprite 13 5 3 item:VIOLIN 0 0
