2b2b2b2b2b2b2b2b2b2b2b2b2b2b2b2b2b2b2b2b
3b3b3b3b3b3b3b3b3b3b3b3b3b3b3b3b3b3b3b1e
000000000100000200040002020200020102022a
1b1b1b1b1b1b1b1b1c011a1b1b1b1b1b1b1c022a
2b2b2b2b2b2b2b2b2c022a2b2b2b2b2b2b2c022a
3b3b3b3b3b3b1e2b2c003a3b3b3b3b3b1e2c002a
0003000001002a2b2c020200000101032a2c002a
1b1b1b1b1b1b2e2b2d1b1b1b1b1b1b1b2e2c002a
3b3b3b3b3b3b3b3b3b3b3b3b3b3b3b3b3b3c002a
000000000104010100010004000201010003012a
1b1b1b1b1b1b1b1b1b1b1b1b1b1b1b1b1b1b1b2e
2b2b2b2b2b2b2b2b2b2b2b2b2b2b2b2b2b2b2b2b
tilesheet 1
neighborw 28
