0101010101010101010101010101010101010101
0101010101010101010101010101010101010101
0101010101220523232323232323232201010101
0101010101201516171826313131312001010101
0101010101200000000036373737372001010101
0101010101200000000000000000002001010101
0101010101200000000000000000002001010101
0101010101200000000000000000002001010101
0101010101300200041111111111113001010101
0101010101211213142121212121212101010101
0101010101010101010101010101010101010101
0101010101010101010101010101010101010101
tilesheet villint
indoors
door 7 9 8 16 3
sprite 14 7 3 item:VIOLIN 0 0
