3b3b3b3b3b3b3c0100000000003a3b3b3b3b3b3b
1701010400020002000000000015161616161616
2700000000030000000000000035192618363636
2702034445020000000000000001252627010202
3700015455000300020000000001252627010100
0000000001000144450100000000060606020200
000068696a010254550100000002252627010202
000078797a010004030000000000252627030101
000088898a010000000000000100252627000003
0100020103000000000000000215292628161616
1c01040000000000000200000035363636363636
2d1c0000000000001a1b1b1b1b1b1b1b1b1b1b1b
tilesheet 1
neighborn 2
neighbors 4
neighborw 8
sprite 10 8 15 0 0 0
sprite 4 4 16 0 0 0
neighbore 20
sprite 15 5 27 4 0 0
sprite 12 10 9 4 0 0
