1836363636363701000000000435363636363619
2700010001010000000000000002010002000125
2700000000000000000000000000000000000425
2702000000000000000000000000000000000025
3700000000000000000000000000000000000025
0000000000000000000000000000000000000125
0000000000000000000000000000000000000125
0000000000000000000000000000000000000025
0000000000000000000000000000000000000025
0400000000000000000000000000000000000025
1701010000000000000000000002000003010025
2817010000000000000000000000151616161629
tilesheet 1
neighborn 2
neighbors 4
neighborw 8
