3b3b3b3b3b3b3c0100000000023a3b3b3b3b3b1e
170101040002000200000000020100000101002a
270000000003000000000000000000000000002a
270203444502000000000000000000030000012a
3700015455000300020000000068696a0000002a
0000000001000144450100000078797a0000012a
0000020103010254550100000088898a0000002a
000000444501000403000000010101010200032a
000001545501000000000000000000000000032a
010002010300000000000000000000000000002a
1c0104000000000000020000010000020000012a
2d1c0000000000001a1b1b1b1b1b1b1b1b1b1b2e
tilesheet 1
neighborn 2
neighbors 4
neighborw 8
