1836363636363701000000000435363636363619
2700010001010000000000000002010002000125
2700000000030000000000000000000000000425
2702034445020000000000000000000300000025
3700015455000300020000000068696a00000025
0000000001000144450100000078797a00000125
0000020103010254550100000088898a00000125
0000004445010004030000000101010102000025
0000015455010000000000000000000000000025
0400020103000000000000000000000000000025
1701010000000000000000000002000003010025
2817010000000000000000000000151616161629
tilesheet 1
neighborn 2
neighbors 4
neighborw 8
