2727272727284142414241424142414241424040
2727272727284141424142414241424142400040
2727272727284142414241424142414241420040
3737373737384141424142414241424142400040
0000000000004142414241424142000041420040
0010111111124041424142414240000040400040
0030313114224142414241424142000041420040
0000000020224041424010111111111111120040
1800000020224142414220252121252535220040
2800000020231111111124352135352115220040
2918000030313131141331313131313131320040
2729184142414200202200414241424142414240
tilesheet castleext
neighborw 4
neighborn 20
neighbors 31
