0202020202020202020202020202020202020202
0202020202020202020202020202020202020202
0202020202020202020202020202020202020202
0202020214313131313131143131311402020202
0202020214000000000000210000001402020202
0202020214000000000000310001001402020202
0202020214000000000000000000001402020202
0202020214000000000000140000001402020202
0202020221212121212101212121212102020202
0202020202020202020202020202020202020202
0202020202020202020202020202020202020202
0202020202020202020202020202020202020202
tilesheet villint
door 10 8 8 4 3
sprite 7 5 moonsong gs:moonsong 0 0
sprite 11 6 gate gs:mns_switch 0 0
sprite 5 4 treadle gs:mns_switch 0 0
door 13 5 31 13 5
