2b2b1d3b3b3b3b3b3b3b3b3b3b1e2b2b2b2b2b2b
2b1d3c000000000000000000002a2b2b2b2b2b2b
2b2c00000000000000000000002a2b2b2b2b2b2b
1d3c0000000000000000001a1b2e2b2b2b2b2b2b
2c000000000000000000002a1d3b1e2b2b2b2b2b
2d1b1b1b1c001a1b1b1c002a2c022a2b2b2b2b2b
1d3b3b1e2c002a1d3b3c003a3c003a3b3b1e2b2b
2c00002a2c002a2c0000000000000000002a2b2b
2c00002a2c002a2d1b1c001a1c001a1b1b2e2b2b
2c00003a3c003a3b3b3c002a2c002a2b2b2b2b2b
2d1c0000000000000000002a2c002a2b2b2b2b2b
2b2d1b1b1b1b1b1b1b1b1b2e2d1b2e2b2b2b2b2b
tilesheet caves
door 13 5 30 13 5
dark
