2727284141424000202200404142414241424142
1937384142414200202200414241424142414241
2800001011111111242311111111111111111111
2800002021151535252125352115212525351515
2800002021133131313131313131313131313131
2800002015221b1c1c1d00000000000000000000
2800002015222b2c2c2e1c1c1c1c1c1c1c1c1c1c
2800002025222b2c2c1e3c3c3c3c3c3c3c3c3c3c
2800002035223b1f1e3d00000000000000000000
280000203522002b2d0000000000000000000000
280000202522002b2d0000000000000000000000
280000203522002b2d0000000000000000000000
tilesheet castleext
neighborn 30
neighbors 32
neighbore 34
