2b2b2b2b2b2b2b2b2b2b2b2b2b2b2b2b2b2b2b2b
2b1d3b3b303132333b3b1e2b2b2b2b2b2b2b2b2b
1d3c00004041424300003a1e2b2b2b2b2b2b2b2b
2c000000000000000000002a2b2b2b2b2b2b2b2b
2c0000000000000000001a2e1d3b1e2b2b2b2b2b
2d1b1c000000000000003a3b3c022a2b2b2b2b2b
2b2b2d1c000000000000000000002a2b2b2b2b2b
2b2b2b2c000000000000000000002a2b2b2b2b2b
2b2b2b2c000000000000001a1b1b2e2b2b2b2b2b
2b2b2b2d1c00000000001a2e2b2b2b2b2b2b2b2b
2b2b2b2b2d1b1b1b1b1b2e2b2b2b2b2b2b2b2b2b
2b2b2b2b2b2b2b2b2b2b2b2b2b2b2b2b2b2b2b2b
tilesheet caves
door 13 5 30 13 5
indoors
