0202020202020202020202020202020202020202
0202020202020202020202020202020202020202
0202133131313131313131313131313131130202
0202130000000000000000000000000000130202
0202130000000000000000000000000000130202
0202130000000000000000000000000000130202
0202130000000000000000000000000000130202
0202130000000000000000000000000000130202
0202130000000000000000000000000000130202
0202212121212121212101212121212121210202
0202020202020202020202020202020202020202
0202020202020202020202020202020202020202
tilesheet villint
door 10 9 6 10 6
