5053505350515253505350515253505326272727
6063606360616263606360616263606326272727
5051525300000000505152535051525326272727
6061626300000000606162636061626326272727
505350530000000050535051525350533637371a
6063606300000000606360616263606300000026
0000000000000000000000000000000000000026
1111111111111111111111120000000000000026
3521151515352115151525220000000000000026
3131313131313131313131320000000000000026
0000000000000000000000000000000000000026
171717171717171717171717171717171717172a
tilesheet castleext
neighborw 33
