1837000000000000000000000000252626262626
3702020000000000000000000000252626262626
0102000000000000000000000000252626262626
0000000000000000000000000100252626262626
0000000000000000000000000315292626262626
0000000000000000000003011529262626262626
0000000000000400000015162926262626262626
0303000000000015161629262626262626262626
1616161616161629262626262626262626262626
2626262626262626262626262626262626262626
2626262626262626262626262626262626262626
2626262626262626262626262626262626262626
tilesheet 1
neighborn 3
neighborw 5
