1d3b3b3b3b3b3b3b3b3b3b3b3b3b3b3b3b3b3b1e
2c1517010000000103010401000400000015172a
2c2527000000000000000000000300020025272a
2c2527020001000001000404000000010025272a
2c2527000000000000020000030100000125272a
2c2527000102010400000101020100000225272a
2c2527020000010002000101000101000125272a
2c2527010001020000000000000102000425272a
2c2527000201010002020200010002000025272a
2c2527000001000200010100040000020025273a
2c25281616161616160716161616161616292816
2c25262626262626260726262626262626262626
tilesheet midlands
song toil_and_trouble
neighbors 2
neighbore 8
sprite 1 6 seamonster 0 0 0
sprite 18 4 seamonster 0 0 0
sprite 9 9 bonfire 0 0 0
