2626262626262626262626262626262626262626
2626262626262626262626262626262626262626
2626262626262626262626262626262626262626
2626262626262626262626262626262626262626
2626262626261836363636192626262626262626
2626262626262701030001252626262626262626
2626262626262702000002252626262626262626
2626262626262702000003252626262626262626
2626262626262700000101252626262626262626
2626262626262816161616292626262626262626
2626262626262626262626262626262626262626
2626262626262626262626262626262626262626
tilesheet beach
neighbore 42
blowback
neighborn 44
ancillary
buried_treasure 8 7 0 item:HAT
