2626262626262626262626262626262626272a2b
2626262626262626262626262626262626273a3b
2626262626262626262626262626262626281616
2626262626262626262626262626262626262626
2626262626262626262626262626262626262626
2626262626262626262626262626262626262626
2626262626262626262626262626262626262626
2626262626262626262626262626262626262626
2626262626262626262626262626262626262626
2626262626262626262626262626262626262626
2626262626262626262626262626262626262626
2626262626262626262626262626262626262626
tilesheet beach
neighbors 43
neighbore 22
blowback
neighborn 45
ancillary
