2618363636370000000000000025262626262626
261a1c1b1a1c0000101200000035363636363636
262a2c2f0d0e0010242312000043000000000004
360a0c3f1d1e1024212122000053000000707171
1111111111112421212122000050717171621011
2121212121212121212123111253101111123031
2121212113313131313131313253303131320000
31313131324f1b4f007071717162000000000002
16161616175f2f5f001516161616161616161616
26262626276f3f6f003519262626262626262626
2626262628170000000025262626262626262626
2626262626281616161629262626262626262626
tilesheet village
neighbore 4
neighborw 6
neighborn 8
sprite 8 7 10 0 0 0
sprite 15 3 3 5 0 0
door 3 3 19 11 8
