2626262626270000000000000025262626262626
2626183636370010111112000035363636363636
2618370000000020211332000000000000000004
3637101111120030313200000010111112000000
1111242121231200030000001024212123111111
2121212121212200383f38003031142121133131
2121212113313200383939000000303131320000
3131313132000001000000000200000000000002
1616161616161616161616161616161616161616
2626262626262626262626262626262626262626
2626262626262626262626262626262626262626
2626262626262626262626262626262626262626
tilesheet village
neighbore 4
neighborw 6
neighborn 8
door 9 5 1 3 8
