5555555555554765656565656600002022002a2b
555555476565664f1b1a1c1b1c00002022003a3b
555555564300005f2f0d0e2b2c00002022000000
656565665300006f3f1d1e3b3c00002022001011
0000000053000000000000000010112423112421
0000000053000000000000431024212121212121
0000000053000000000000532021133131313131
0000000060717171717171622021220000151616
0000101111111111111111112421221516292626
0000303131313131313131313131322526262626
1616161616161616161616161616162926262626
2626262626262626262626262626262626262626
tilesheet village
song tangled_vine
neighborw 2
neighbore 6
neighborn 8
neighbors 13
sprite 8 3 farmer 3 0 0
door 8 3 27 9 10
