262626262626262626262626262626262626272a
262626262626262626262626262626262626272a
262626262626262626262626262626262626272a
262626262626262626262626262626262626272a
262626262626262626262626262626262626272a
262626262626262626262626262626262626272a
262626262626262626262626262626262626272a
262626262626262626262626262626262626272a
262626262626262626262626262626262626272a
262626262626262626262626262626262626272a
363636363636363636363636363636363636372a
1b1b1b1b1b1b1b1b1b1b1b1b1b1b1b1b1b1b1b2e
tilesheet beach
neighborw 49
neighbors 9
neighbore 4
blowback
neighborn 51
ancillary
