2626262626262626262626262626262626262626
2626262626262626262626262626262626262626
2626262626262626262626262626262626262626
2626262626262626262626262626262626262626
2626262626262626262626262626262626262626
2626262626262626262626262626262626262626
2626262626262626262626262626262626262626
2626262626262626262626262626262626262626
2626262626262626262626262626262626262626
2626262626262626262626262626262626262626
3636363636363636363636363636363636363636
1b1b1b1b1b1b1b1b1b1b1b1b1b1b1b1b1b1b1b1b
tilesheet beach
neighborw 52
neighbors 8
blowback
neighbore 54
