2626262618363636363619262626262626262626
2618363637001012000035363636192626262626
1837000000002022000000000000353636363619
2710120000002022000000000000000000000025
2720231200002022000000000000000000000025
2730142311112422000000000000000000000025
2817303114212123120000000000000000000025
2628161730142121231112000000000000000025
2626262817303131313132000000000000000025
2626262628170000000000000000000000000025
2626262626281616161616161616161616161629
2626262626262626262626262626262626262626
tilesheet village
song tangled_vine
neighborw 5
neighborn 7
neighbors 18
neighbore 57
ancillary
