2b2c2a2b2c0020220000000000001a1b1c1a1c25
3b3c3a3b3c0020220000000000002a2b2c2a2c25
00004a4b000020220000000000003a3b3c3a3c25
1111120000002022000000000000000000000025
2121231200002022001a1b1a1b1a1b1c00000025
2121212311112422002a2f0d2b2b2b2c73007325
3131313114212123123a3f3a3b3a3b3c00000025
1616161730142121231112430000000000000025
2626262817303131313132530039003900390025
2626262628170000000000630000000000000025
2626262626281616161616161616161616161629
2626262626262626262626262626262626262626
tilesheet village
song tangled_vine
neighborw 5
neighborn 7
neighbors 18
sprite 17 5 10 0 0 0
sprite 13 8 ghost 0 0 0
sprite 15 8 ghost 0 0 0
sprite 17 8 ghost 0 0 0
door 10 6 32 10 9
