2626183636363636363636363636363636192626
2626271a1c1c1b1a1a1c1b1a1c1b1a1c1c351926
2626272d2e2c2f2a0d0e2b2d2e2f2d2e2c003519
2626273d3e3c3f3a1d1e0b3d3e3f3d3e3c000035
2626274301010101014310111111111111111111
2626276301430101015320133131313131311421
2626271012530101015320221516170003003014
2626272022530101015320222526281617010330
2626272022607171716220222526262628161616
2626272023111111111124222526262626262626
2626273031313131313131322526262626262626
2626281616161616161616162926262626262626
tilesheet village
neighbore 5
neighborn 7
sprite 4 5 10 0 0 0
sprite 7 6 3 8 0 0
