2626183636363636363636363636363636192626
2626270101010101000100030402010300351926
2626270101010101010101000000000000003519
2626270101010101010100010000000000000035
2626270101010101010110111111111111111111
2626270110120101010120133131313131311421
2626281720231111111124221516170003003014
2626262730313131313131322526281617010330
2626262816161616161616162926262628161616
2626262626262626262626262626262626262626
2626262626262626262626262626262626262626
2626262626262626262626262626262626262626
tilesheet village
neighbore 5
neighborn 7
