2626262618363636363619262626262626262626
2618363637001012000035363636192626262626
1837000000002022000000000000353636363636
2710120000002022000000000000000000000000
2720231200002022000000000000000000000000
2730142311112422000000000000000000000000
2817303114212123120000000000000000000000
3637000030142121231112000000000000000000
0000000000303131313132000000000000000000
0000000000000000000000000000000000000000
0000000000000015161616161616161616161616
1616161616161629262626262626262626262626
tilesheet village
song tangled_vine
neighborw 5
neighborn 7
neighbors 18
neighbore 57
ancillary
sprite 0 9 firewall 0 0 0
sprite 19 6 firewall 0 0 0
sprite 2 2 pitchfork 1 0 0
sprite 13 2 pitchfork 0 0 0
sprite 13 9 rat 0 0 0
