26262626270020220000000000001a1b1c1a1c25
26183636370020220000000000002a2b2c2a2c25
18370000000020220000000000003a3b3c3a3c25
2710120000002022000000000000000000000025
2720231200002022000000002121210000000025
2730142311112422000000000000002100000025
2817303114212123120000000021210000000025
2628161730142121231112000000000000000025
2626262817303131313132000021000000000025
2626262628170000000000000000000000000025
2626262626281616161616161616161616161629
2626262626262626262626262626262626262626
tilesheet village
song tangled_vine
neighborw 5
neighborn 7
neighbors 18
