2b2b2b2b2b2b2b2b2b2b2b2b2b2b2b2b2b2b2b2b
2b2b2b2b2b2b2b2b2b2b2b2b2b2b2b2b2b2b2b2b
2b2b2b2b1d3b1e2b2b1d3b3b3b3b3b1e2b2b2b2b
2b2b2b2b2c022a2b1d3c00151616173a1e2b2b2b
2b2b2b2b2c002a1d3c000025262628173a3b3b3b
2b2b2b2b2c003a3c000000252626262700000000
2b2b2b2b2c000000000000252626262700000000
2b2b2b2b2d1b1c0000000025262626271a1b1b1b
2b2b2b2b2b2b2d1b1b1c0025262618372a2b2b2b
2b2b2b2b2b2b2b2b2b2d1c353636371a2e2b2b2b
2b2b2b2b2b2b2b2b2b2b2d1b1b1b1b2e2b2b2b2b
2b2b2b2b2b2b2b2b2b2b2b2b2b2b2b2b2b2b2b2b
tilesheet caves
door 5 3 7 5 3
neighbore 65
indoors
