2626262626262627010000000000000000000035
2626262626262627000000000000000000000000
2626262626262627030000000000000000000000
2626262626262627010000000000000000000000
2626262626262627000000000000000000000000
2626262626262627020000000000000000000000
2626262626262627000000000000000000000000
2626262626262627010000000000000000000000
2626262626262627020000000000000000000000
3636363636363637030100020000010000000202
1b1b1b1b1b1b1b1b1b1b1b1b1b1b1b1b1b1b1b1b
2b2b2b2b2b2b2b2b2b2b2b2b2b2b2b2b2b2b2b2b
tilesheet 1
neighbors 6
neighbore 8
neighborn 9
song 3
