2626262626262627010000000000000000000035
2626262626262627000000000000000000000000
2626262626262627030301000000000000000000
26262626262626271a1b1b1b1b1b1c0000000000
26262626262626273a3b3b3b3b3b3c0100000000
2626262626262627000100020103000000000000
2626262626262627000000000000000000000000
2626262626262627010000000000000000000000
2626262626262627020000000000000000000000
3636363636363637000000010102000000000202
1b1b1b1b1b1b1b1c000000020301001a1b1b1b1b
2b2b2b2b2b2b2b2c000001010000012a2b2b2b2b
tilesheet 1
neighbors 6
neighbore 8
neighborn 9
song 3
neighborw 21
sprite 8 11 firewall 0 0 0
sprite 10 6 26 0 0 0
sprite 9 2 26 0 0 0
sprite 16 6 26 0 0 0
