3636363636363636363636363636363636363619
1a1c4300001a1c000000004f1b1a1a1c00000025
0d0e5300000d0e000000005f2f2a0d0e00000025
1d1e5310121d1e101111126f3f3a1d1e00001529
1617532023111124212123111200000000002526
2627533031313131311421212311111200002526
3637530000000000003031141331313200002526
0000607171717171717172202270717171723519
0000001011111111111111242311120000000025
0000003031311413313131313131320000000025
0000000000002022000000000000151616161629
1b1b1a1b1c002022000000000000353636363619
tilesheet village
song tangled_vine
neighbors 6
neighborw 8
sprite 8 2 15 0 0 0
door 12 3 28 10 8
