2626262626262627010000000000000000000035
2626262626262627000000000000000000000000
2626262626262627030000000000000000000000
2626262626262627010000000000000000000000
2626262626262627000000000000000000000000
2626262626262627020000000000000000000000
2626262626262627000000000000000000000000
2626262626262627010000000000000000000000
2626262626262627020000000000000000000000
2626262626262627000000000000000000000000
2626262626262627000000000000000000030115
2626262626262627000000000000000000001529
tilesheet 1
neighbors 6
neighbore 8
neighborn 9
