3636363636363636363636363636363636363619
0100000100000103010001000002040200000025
0000000000030000000101000000000000000025
0000000000041516161616161700000000000125
0000000000002518363636192700000000000035
0000000000032527020200252700000000000102
0000000000002527000503252702000000000000
0000000000003537020001353701000000000000
0000000000010103000000010201000000000000
0000000000000000000000000000000000000004
1700000000000000000000000000000000000115
2817000000000000000000000000000000011529
tilesheet 1
neighborw 7
neighbors 5
neighbore 3
neighborn 1
