3636363636363636363636363636363636363619
0100000100000103010001000002040200000025
0000000000000000000000000000000000000025
0000000000000000000000000000000000000125
0000000000000000000000000000000000000035
0000000000000000000000000000000000000102
0000000000000000000000000000000000000000
0000000000000000000000000000000000000000
0000000000000000000000000000000000000000
0000000000000000000000000000000000000004
1700000000000000000000000000000000000115
2817000000000000000000000000000000011529
tilesheet 1
neighborw 7
neighbors 5
neighbore 3
neighborn 1
