36363636363636363636363636363636373a3b3b
0102000001000101010001000002040202000015
00041a1b1b1b1b1b1c0001000000000000000025
00012a1d3b3b3b3b3c0003000000000000000125
00012a2c00010100020001000202000000000035
00002a2c0000011a1c0102010300000000000102
00012a2c0100003a3c0001000000000000000000
00022a2c00000000000001020100000000000000
00002a2d1b1b1b1b1c0204000102000000000000
01043a3b3b3b3b3b3c0000000000000000000001
1c0300000101000204000000000000000001021a
2d1b1b1b1b1c020000000000001a1b1b1b1b1b2e
tilesheet 1
neighborw 7
neighbors 5
neighbore 3
neighborn 1
sprite 7 4 10 1 0 0
sprite 14 7 8 1 0 0
sprite 15 4 1 0 0 0
sprite 5 5 3 15 0 0
sprite 16 8 9 2 0 0
sprite 7 7 10 2 0 0
