1836363636363636363636363636363636363636
271a1b1c1b1a1c00000059004300004f1b1a1b1c
272a2b2c1f2a2c0000494a4b6300005f1f2a2b2c
273a3b3c2f3a3c00444545454546006f2f3a3b3c
2700000000000000545555555557460000001516
2700000000000044585555555555560000003519
2700000000000054555555555555560000000035
2770717200707264485555555547660000000000
2700000000000000646565656566000000000000
3700000000000000000000000000000000000000
4545454545454545454610120000000000000015
5555555555555555555620221a1b1b1b1b1c1529
tilesheet village
song snowglobe
neighbore 7
neighbors 5
neighborw 4
door 16 3 29 7 9
door 4 3 30 9 9
transmogrify 10 2 from 1
neighborn 53
