1836363636363636363636363636363636363636
271a1b1c1b1a1c00000039004300004f1b1a1b1c
272a2b2c2f2a2c00000000006300005f2f2a2b2c
273a3b3c3f3a3c00444545454546006f3f3a3b3c
2700000000000000545555555557460000001516
2700000000000044585555555555560000003519
2700000000000054555555555555560000000035
2770717200707264485555555547660000000000
2700000000000000646565656566000000000000
3700000000000000000000000000001011120000
4545454545454545454545460000002013320000
5555555555555555555555574600002022001a1b
tilesheet village
song tangled_vine
neighbore 7
neighbors 5
neighborw 4
door 16 3 29 7 8
door 4 3 30 10 8
transmogrify 10 2 from 1
