0101010100000000000000000001351926262626
0100010001000201000100000004003519262626
0000000101000002020200010000010035192626
0000010101000103000001000000020101353636
0000010200000000000000020004000002000100
0001000000000200000401000000010100010100
0200010300000001000402020202000000000000
0000000101000100010100010000000001010000
0101030202000002000402010402000200000000
0201000104000004000200000002030100101111
0102000000010101000001000010111111242121
1111111111111111111111111124212121212121
tilesheet mountains
song seven_circles
neighbore 2
neighborw 10
neighborn 12
neighbors 23
sprite 17 1 34 0 0 0
sprite 6 3 3 item:CHALK 0 0
