2121212121212122000001202121212121212121
2121212121212122010301202121212121212121
2121212121212122000302202121212121212121
2121212121212122000003202121212121212121
2121212121212122000001202121212121212121
313131313131313201010230311f313131313131
1616161616161617010001000000000000020115
2626262626262627020000000000000000000025
2626262626262627000000000000000000000025
2626262626262627010000000000000000000225
2626262626262627000000000000000000000325
2626262626262627000000000000000000000125
tilesheet 1
neighbors 7
neighbore 1
neighborn 12
song 2
neighborw 22
