2121212121212122000001202121212121212121
2121212121212122010300303114212121212121
2121212121133132000302000020212121212121
2121212121220100010002101124212121212121
2121212121231112000001202121212121212121
3131313131313132010102303131313131313131
1616161616161617010001000000000000020115
2626262626262627020000000000000000000025
2626262626262627000000000000000000000025
2626262626262627010000000000000000000225
2626262626262627000000000000000000000325
2626262626262627000000000000000000000125
tilesheet 1
neighbors 7
neighbore 1
neighborn 12
song 2
neighborw 22
sprite 6 3 pitchfork 1 0 0
sprite 12 2 pitchfork 0 0 0
sprite 9 6 lizard 0 0 0
sprite 14 7 lizard 0 0 0
sprite 3 8 34 0 0 0
