2121212121220120212121212122351926262626
2121212121220320212121212122013519262626
2113313114220020211331313132010035192626
3132020030320320212200020100020101353636
0204010002340020133202000004010000000100
1111111200000230320000330200003400010100
2121212201000002000201000002010002000000
2121212200000100010100010000000001010000
2121212203000002000402010402000200000000
2121212312000104000200000002030100101111
2121212123120001000001000010111111242121
2121212121231111111111111124212121212121
tilesheet mountains
song seven_circles
neighbore 2
neighborw 10
neighborn 12
neighbors 23
sprite 17 1 34 0 0 0
sprite 5 5 chalkguard 1 2 0
sketch 10 2 853504
sketch 11 2 606243
sketch 12 2 99466
sketch 13 2 265860
