484902c6c80148494a48494a48494a48494a4849
585900c6c80058595ad0d1d2d3d45a58595a5859
000000c6c864000001e0e1e2e3e4000002020400
010000d6d800000100f0f1f2f3f4650001020403
03000002010000000100010093949503031a1b1b
000003000100020100000000010100001a2e2b2b
010001000101000100010101000000013a1e2b2b
1616161616161617020303011a1c0000003a1e2b
2626262626262628170001002a2d1c0101033a3b
3636363636361926270001013a1e2c1516161616
000100000200252627010402022a2c3536192626
1c0001000200252627010002002a2d1b1c252626
tilesheet forest
song toil_and_trouble
hero 13 4
neighborw 2
neighbore 6
neighborn 11
neighbors 15
door 11 3 20 10 9
