48494a48494a48494a48494a48494a48494a4849
58595a58595ad0d1d2d3d45a58595a58595a5859
000001020164e0e1e2e3e4006300000002020400
030002020000f0f1f2f3f4000100650001020403
16161617000000000093949500000003031a1b1b
262626281617010004010001000100001a2e2b2b
363619262628170000010101000000013a1e2b2b
0100353619262817020303011a1c0000003a1e2b
0001030035192628170001002a2d1c0101033a3b
0401020203351926270001013a1e2c1516161616
020000000000252627010402022a2c3519262626
1c0001000200252627010002002a2d1c25262626
tilesheet forest
song toil_and_trouble
hero 10 4
neighborw 2
neighbore 6
neighborn 11
neighbors 15
door 8 3 20 10 9
