1d3b3b3b3b3b3b3b3b3b3b3b3b3b3b3b3b3b3b1e
2c0000000000000000000003020001010100022a
2c0001020100000100020000000101040202002a
2c0300000002010001010300020000030201002a
2c0200000200010000027374750300000000002a
2c0103000102000000008384850100010004002a
2c0301010101020200009394950000000100012a
2c0001000200010000000100000100010002002a
2c0001000000000101000103000000000000002a
2c0002020200030102000101000202000001002a
2c0101000201000301000203000003030301002a
2d1b1b1b1b1b1b1b1b1b1b1b1b1b1b1b1b1b1b2e
tilesheet midlands
song toil_and_trouble
hero 11 6
