4462626262626262626262626262626262626262
5300000000000000000000000000000000000000
5300000000000000000000000000000000000000
5300000000000000000000000000000000000000
5300000000000000000000000000000000000000
5300000000000000000000000000000000000000
5300003e3d000000000000000000000000000000
5300003d003e0000000000000000000000000000
5300003e3e000000000000000000000000000000
5300000000000000000000000000000000000000
6300000000000000000000000000000000000000
1b1b1b1c000000000000000000000000001a1b1b
tilesheet desert
neighbors 7
neighborw 23
neighbore 26
neighborn 52
