5252525244626262626262626262626262626262
5252446263000000000000000046474747474747
5244630000000000000000000056575757575757
525300000000000000000000465a575757575757
4463000000464748000000465a57575757575757
53000000465a4968000000565757575757575757
5300000056496800000000664a57575757574967
5300000066680000000000006667674a49676841
5300000000000000000000000000006668414255
5300000000000000000000000000004142555252
6300000000000000000000004142425552525252
1b1b1b1c00000000004142425552525252525252
tilesheet desert
song blood_for_silver
neighbors 7
neighborw 23
neighbore 26
neighborn 52
