2121212121212121212121212121212121212121
3131313114133131313131313131141331313131
0000000020220000000000000000202200000000
1112000020220000000000000000202200001011
2122000020220000000000000000202200002021
2122000020220000000000000000202200002021
2122000020231111111111111111242200002021
2122000030313131313131313131313200002021
2122000000000000000000000000000000002021
2122000000000000000000000000000000002021
2123111111111111111111111111111111112421
2121212121212121212121212121212121212121
tilesheet castleint
flags indoors
neighborw 99
sprite 15 4 firenozzle_e 2 0 gs:ww_eqs1
sprite 15 3 firenozzle_e 2 0 gs:ww_eqs2
sprite 12 4 treadle gs:ww_eqs1 0 0
sprite 12 3 treadle gs:ww_eqs2 0 0
sprite 7 3 pushblock 0 0 0
sprite 10 5 pushblock 0 0 0
neighbore 115
neighbors 117
