2b2b2b2b2b2b2b2b2b2b2b2b2b2b2b2b2b2b2b2b
2b2b2b2b2b2b2b2b2b2b1d3b3b3b1e2b2b2b2b2b
2b2b2b2b2b2b2b2b2b2b2c0000002a2b2b2b2b2b
2b2b2b2b2b1d3b3b3b3b3c0000003a1e2b2b2b2b
2b2b2b1d3b3c0000000000000000002a2b2b2b2b
2b2b2b2c00000000000000000000002a2b2b2b2b
2b2b2b2c00000000000000000000002a2b2b2b2b
2b2b2b2d1c0000000002000000001a2e2b2b2b2b
2b2b2b2b2d1c00000000000000002a2b2b2b2b2b
2b2b2b2b2b2d1b1c000000001a1b2e2b2b2b2b2b
2b2b2b2b2b2b2b2d1b1b1b1b2e2b2b2b2b2b2b2b
2b2b2b2b2b2b2b2b2b2b2b2b2b2b2b2b2b2b2b2b
tilesheet caves
flags indoors
door 9 7 25 6 3
sprite 12 3 treasure item:VIOLIN 0 0
