2b2b2b2b2b2b2b2b2b2b2b2b2b2b2b2b2b2b2b2b
2b2b1d3b3b3b3b3b3b3b3b3b3b3b3b3b1e2b2b2b
2b2b2c000000000000000000000000002a2b2b2b
2b1d3c000000000000000000000000002a2b2b2b
2b2c00000000000000000000000000002a2b2b2b
2b2c00000000000000000000000000002a2b2b2b
2b2c00000000000000000000000000002a2b2b2b
2b2c002b002b002b002b002b002b00002a2b2b2b
2b2c00002b0000002b0000002b0000002a2b2b2b
2b2c002b002b002b002b002b002b00002a2b2b2b
2b2d1c00000000000000000000001a1b2e2b2b2b
2b2b2d1b1b1b1b1b1b1b1b1b1b1b2e2b2b2b2b2b
tilesheet caves
flags indoors
sprite 12 3 treasure item:VIOLIN 0 0
