9091929392939392929394959091929397929697
929093a0a4a5a6a1a2a3a4a5a6a1a2a3a7919293
909397b0b1b1b1b1b1b1b1b1b1b1b1b1b7939292
939790c0b1b1b1b1b1b1b1b1b1b1b1b1c7919293
929390d0b1b1b1b1b1b1b1b1b1b1b1b1d7929193
979093b0b1b1b1b1b1b1b1b1b1b1b1b1b7929293
929397c0b1b1b1b1b1b1b1b1b1b1b1b1c7939192
939297d0b1b1b1b1b1b1b1b1b1b1b1b1d7939293
909390b0b1b1b1b1b1b1b1b1b1b1b1b1b7929291
979293e0e1e1e1e1e1e1e1e1e1e1e1e1e7939291
909392f0f1f1f1f1f1f1f1f1f1f1f1f1f7939392
93979292f1f1f1f1f1f1f1f1f1f1f1f192919292
tilesheet castleext
sprite 13 3 werewolf gs:orphans_clothed 0 0
song jaws_of_wrath
