0101010101010101010101010101010101010101
0101010101010101010101010101010101010101
0101010122232323232323232323220101010101
0101010120313231333134313531200101010101
0101010120000000000000000000200101010101
0101010120000000000000000000200101010101
0101010120000000000000000000200101010101
0101010120000000000000000000200101010101
0101010120000000000000000000200101010101
0101010120101010101013101010200101010101
0101010101010101010101010101010101010101
0101010101010101010101010101010101010101
tilesheet villint
indoors
door 10 9 11 12 1
sprite 8 5 treasure item:PITCHER 0 0
