0101010101010101010101010101010101010101
0101010101010101010101010101010101010101
0101010122303030303030303030220101010101
0101010120313131313131313131200101010101
0101010120000000000000000000200101010101
0101010120000000000000000000200101010101
0101010120000000000000000000200101010101
0101010120000000000000000000200101010101
0101010120101310101010101310200101010101
0101010101010101010101010101010101010101
0101010101010101010101010101010101010101
0101010101010101010101010101010101010101
tilesheet villint
flags indoors
door 12 8 11 2 3
door 6 8 21 18 3
sprite 9 3 agrifilm 0 0 0
sprite 9 7 projector 0 0 0
