0101010101010101010101010101010101010101
0101010101010101010101010101010101010101
0101010122222222222222222222222201010101
0101010120313131313131313131312001010101
0101010120000000000000000000002001010101
0101010120000000000000000000002001010101
0101010120000000000000000000002001010101
0101010120000000000000000000002001010101
0101010120101310101010101013102001010101
0101010101010101010101010101010101010101
0101010101010101010101010101010101010101
0101010101010101010101010101010101010101
tilesheet villint
indoors
door 13 8 11 2 3
door 6 8 21 18 3
