0101010101010101010101010101010101010101
0101010101010101010101010101010101010101
0101010101223030303030303030220101010101
0101010101203131313131313131200101010101
0101010101200000000000000000200101010101
0101010101200000000000002500200101010101
0101010101200000000000000000200101010101
0101010101200000000000000000200101010101
0101010101200000000000000000200101010101
0101010101201010101310101010200101010101
0101010101010101010101010101010101010101
0101010101010101010101010101010101010101
tilesheet villint
flags indoors
door 9 9 21 14 5
door 12 5 106 12 5
