0101010101010101010101010101010101010101
0101010101010101010101010101010101010101
0101010101223030303020303030220101010101
0101010101203131313120313131200101010101
0101010101200000000020000025200101010101
0101010101200000000030000000200101010101
0101010101200000000031000000200101010101
0101010101200000000000000000200101010101
0101010101200000000000000000200101010101
0101010101201010101310101010200101010101
0101010101010101010101010101010101010101
0101010101010101010101010101010101010101
tilesheet villint
flags indoors
door 9 9 21 14 5
door 13 4 106 13 4
sprite 10 6 firenozzle_e 3 0 gs:school_fire1
sprite 11 4 treadle gs:school_fire1 15 0
sprite 7 5 raccoon 1 0 0
sprite 13 5 pushblock 0 0 0
