0101010101010101010101010101010101010101
0101010101010101010101010101010101010101
0101010101223030303030303030220101010101
010101010120214d4e214d4e2121200101010101
010101010120065d5e065d5e0608200101010101
0101010101200606060606060606200101010101
0101010101200606060930303022200101010101
0101010101204c064c1421212120200101010101
0101010101200b06060606060820200101010101
0101010101202222222020202020200101010101
0101010101010101010101010101010101010101
0101010101010101010101010101010101010101
tilesheet villint
flags indoors
door 13 4 105 13 4
door 6 8 107 6 8
sprite 7 6 alphablock_mu 0 0 0
sprite 8 3 book 42 1 0
sprite 11 3 book 44 1 0
door 12 8 105 12 8
