0101010101010101010101010101010101010101
0101010101010101010101010101010101010101
0101010101223030303030303030220101010101
0101010101202121212121212121200101010101
0101010101200606060606060606200101010101
010101010120060b060606060806200101010101
0101010101200606060606060606200101010101
0101010101200606060606060606200101010101
0101010101200606060606060606200101010101
0101010101202222222222222222200101010101
0101010101010101010101010101010101010101
0101010101010101010101010101010101010101
tilesheet villint
indoors
door 12 5 105 12 5
door 7 5 107 7 5
