0101010101010101010101010101010101010101
0101010101010101010101010101010101010101
0101010101223030303030303030220101010101
010101010120214d4e2121214d4e200101010101
010101010120065d5e0606065d5e200101010101
0101010101200606061a1b1b1b1c200101010101
0101010101200606062a2b2b2b2c200101010101
0101010101200606062a2b2b2b2c200101010101
0101010101200806063a3b3b3b3c200101010101
0101010101202222222222222222200101010101
0101010101010101010101010101010101010101
0101010101010101010101010101010101010101
tilesheet villint
flags indoors
hero 8 6 0
door 6 8 106 6 8
sprite 8 3 book 40 1 0
sprite 11 6 goody 0 0 0
sprite 6 4 gate 0 0 0
sprite 13 3 mysterybook 62 1 0
song snowglobe
