0101010101010101010101010101010101010101
0101010101010101010101010101010101010101
0101010101223030303030303030220101010101
0101010101202121212121212121200101010101
0101010101200606061a1b1b1b1c200101010101
0101010101200608062a2b2b2b2c200101010101
0101010101200606062a2b2b2b2c200101010101
0101010101200606062a2b2b2b2c200101010101
0101010101200606063a3b3b3b3c200101010101
0101010101202222222222222222200101010101
0101010101010101010101010101010101010101
0101010101010101010101010101010101010101
tilesheet villint
flags indoors
door 7 5 106 7 5
