0101010101010101010101010101010101010101
0101222323232323232323232323232323220101
0101203131313131312631313131313131200101
0101200027383927003637373737373737200101
0101200000000000000000000019000000200101
0101200000273839270000272829270000200101
0101200000000000000000000000000000200101
0101200027383927000000002738392700200101
0101200000000000000000000000000000200101
0101201010101010100010101010101010200101
0101010101010101010101010101010101010101
0101010101010101010101010101010101010101
tilesheet villint
flags indoors
door 9 9 21 8 3
sprite 12 2 bartender 0 4 0
sprite 11 5 pamcake 1 0 0
