0101010101010101010101010101010101010101
0101010101010101010101010101010101010101
0101012223232323232323232323232322010101
010101202121214d4e214d4e214d4e2120010101
010101200606065d5e065d5e065d5e0620010101
0101012006060606060606060606060620010101
01010120060b0606060606060606060620010101
0101012006060606060606060606060620010101
0101012006060606060606060606060620010101
0101012022222222220722222222222220010101
0101010101010101010101010101010101010101
0101010101010101010101010101010101010101
tilesheet villint
flags indoors
door 9 9 22 7 7
door 5 6 110 5 6
sprite 8 3 book 38 1 0
sprite 11 3 book 40 1 0
