0101010101010101010101010101010101010101
0101010101010101010101010101010101010101
0101012223232323232323232323232322010101
0101012031313131313131313131313120010101
0101012000000000000000000000000020010101
0101012000000000000000000000000020010101
0101012000250000000000000000000020010101
0101012000000000000000000000000020010101
0101012000000000000000000000000020010101
0101012010101010101310101010101020010101
0101010101010101010101010101010101010101
0101010101010101010101010101010101010101
tilesheet villint
flags indoors
door 9 9 22 7 7
door 5 6 110 5 6
