0101010101010101010101010101010101010101
0101012223d6d7d8232323232323232322010101
0101012221e6e7e821214d4e214d4e2122010101
010101200606060606065d5e065d5e0620010101
010101200606061a1b1b1b1c0606060620010101
010101200606062a2b2b2b2c2222222220010101
01010120060b062a2b2b2b2c144d4e2120010101
010101200606063a3b3b3b3c065d5e0620010101
0101012006060606060606060606060620010101
0101012022222222220722222222222220010101
0101010101010101010101010101010101010101
0101010101010101010101010101010101010101
tilesheet villint
flags indoors
door 9 9 22 7 7
door 5 6 110 5 6
sprite 14 6 book 56 1 0
sprite 11 2 book 58 1 0
sprite 14 2 book 60 1 0
