5d5d5d5d5e000001010d0e2c1f0d0e0320220025
5d5d5d5d5e000104011d1e3c2f1d1e0320220225
2b2c1f0d0e707171716200000000430320220125
3b3c2f1d1e530000000000000000530320220225
0401000000530000000000000000530320220125
0000000001530000000000000000530320220125
0100010001530000000000000000530320220125
1111111112530000000000000000530320220325
3131311422607171717200707171620320220125
0000002023111111111111111111111124220025
0101012013313131313131313131313131320025
1617012022011516161616161616161616161629
tilesheet village
song snowglobe
neighbors 1
neighborn 12
neighborw 21
neighbore 23
sprite 7 4 cow 0 0 0
door 12 1 103 10 9
door 2 3 104 13 8
sprite 12 1 farmer 4 0 0
