2b2b2b2b2c000001012a2b2b1f2b2b2c20220025
2b2b2b2b2c000104013a3b3b2f3b3b3c20220225
2b2b1f2b2c707171716200000000005320220125
3b3b2f3b3c530000000000000000005320220225
0401000000530000000000000000004320220125
0000000001530000000000000000005320220125
0100010001530000000000000000005320220125
1111111112530000000000000000005320220325
3131311422607171717171720070716220220125
0000002023111111111111111111111124220025
0101012013313131313131313131313131320025
1617012022011516161616161616161616161629
tilesheet village
song snowglobe
neighbors 1
neighborn 12
neighborw 21
neighbore 23
sprite 7 4 cow 0 0 0
