1d3b3b3b3b3b3c0000033a3b3b3b3b3b3b3b3b1e
2c0103030000020100000200000202010303022a
2c0000000000000000000000000000000000012a
2c0100000000000000000000000000000000022a
2c0400010000000000000000000000000000012a
2c0138380301000000000000000000000000012a
2c0002003800000000000000000000000000012a
2c0000390300000000000000000000000000032a
2c0301003900000000000000000000000000012a
2c0138390000000000000000000000000000002a
2c0301000101000000020302020000000100002a
2d1b1b1b1b1b1b1b1b1b1b1b1b1b1b1b1b1b1b2e
tilesheet midlands
neighbors 1
neighborn 12
neighborw 21
