0001010001000001010000020100030100020025
0001040100000104010001000100000401030225
0300003900390000000000000000000000000125
0001003800390000000000000000000000000225
0401000038000000000000000000000000000125
0000000001010000000000000000000000000125
0100010001000000000000000000000000000125
0000000000020000000000000000000000000325
0000000200000000000000000000000000000125
0000000002000000000000000000000000000025
0101010001040000000203020200000001000025
1616161616161616161616161616161616161629
tilesheet village
neighbors 1
neighborn 12
neighborw 21
neighbore 23
