0101010101010101010101010101010101010101
0101010101010101010101010101010101010101
0101012223232323232323232323232322010101
0101012021212121212121212121212120010101
0101012006060606060606060606060620010101
0101012006060606060606060606060620010101
0101012006080606060606060606060620010101
0101012006060606060606060606060620010101
0101012006060606060606060606060620010101
0101012022222222222222222222222220010101
0101010101010101010101010101010101010101
0101010101010101010101010101010101010101
tilesheet villint
flags indoors
door 5 6 109 5 6
