0101010101010101010101010101010101010101
0101010101010101010101010101010101010101
0101010101010101010101010101010101010101
01010101222323230d0e23232323232201010101
01010101203131261d1e26313131312001010101
010101012000002d00002d000000002001010101
010101012000003600003d000000002001010101
0101010120000000000000000000002001010101
0101010120000000000000000000002001010101
0101010120101010101310101010102001010101
0101010101010101010101010101010101010101
0101010101010101010101010101010101010101
tilesheet villint
flags indoors
door 9 9 22 13 5
sprite 8 6 coincollector 20 gs:hat_collect_7bit 0
sprite 8 5 treasure item:HAT 0 0
