0101010101010101010101010101010101010101
0101010101010101010101010101010101010101
0101010101010101010101010101010101010101
0101010122232323232323232323232201010101
0101010120313131313131313131312001010101
0101010120000000000000000000002001010101
0101010120000000000000000000002001010101
0101010120000000000000000000002001010101
0101010120000000000000000000002001010101
0101010120101010101310101010102001010101
0101010101010101010101010101010101010101
0101010101010101010101010101010101010101
tilesheet villint
indoors
door 9 9 22 13 5
