0101010101010101010101010101010101010101
0101010101010122232323232322010101010101
0101010101010120313131313120010101010101
0101010101010120000000000020010101010101
0101010101010120000000000020010101010101
0101010101010120000000000020010101010101
0101010101010120000000000020010101010101
0101010101010120000000000020010101010101
0101010101010120000000000020010101010101
0101010101010120000000000020010101010101
0101010101010120101013101020010101010101
0101010101010101010101010101010101010101
tilesheet villint
flags indoors
door 10 10 22 18 6
