0101010101010101010101010101010101010101
0101010101010122232323232322010101010101
0101010101010122212121212122010101010101
0101010101010120060606060620010101010101
01010101010101201a1b1b1c0620010101010101
01010101010101202a2b2b2c0620010101010101
01010101010101203a3b3b3c0620010101010101
0101010101010120060606060620010101010101
0101010101010120222207222220010101010101
0101010101010101010101010101010101010101
0101010101010101010101010101010101010101
0101010101010101010101010101010101010101
tilesheet villint
flags indoors
door 10 8 22 18 6
sprite 12 5 musicteacher gs:music_teacher_selection_2bit 0 0
sprite 12 3 treadmill 0 0 0
sprite 9 2 musicstand gs:music_teacher_selection_2bit 0 0
