0101515151515354555151515101010101010101
0101515151516364655151515151515151010101
0101515151515151515151515150505051010101
0101517373737172737373735150705051010101
0101518484848182838484845150505051010101
0101515050505050505050505150505051010101
0101515061526250615262505150505051010101
0101515050505050505050505050505051010101
0101515061526250615262505151515151010101
0101515050505050505050505101010101010101
0101515151515160515151515101010101010101
0101010101010101010101010101010101010101
tilesheet villint
indoors
door 7 10 12 12 5
door 14 3 114 14 3
