0101010101010101010101010101010101010101
0101010101010101010101015151515151010101
0101010101010101010101015174747451010101
0101010101010101010101015174807451010101
0101010101010101010101015174747451010101
0101010101010101010101015174747451010101
0101010101010101010101015174747451010101
0101010101010101010101015174747451010101
0101010101010101010101015174747451010101
0101010101010101010101015151755151010101
0101010101010101010101010101010101010101
0101010101010101010101010101010101010101
tilesheet villint
flags indoors
door 14 3 113 14 4
door 14 9 12 17 1
