2626262626262626262626262626262626262626
3636363636363619262626262626262626262626
0000000080818225262626262626262626262626
1700000090919235363636361918363636363619
2700000090919200000000002527000000000025
2700000090919215170015162927001517000025
2700000090919235370025262627002527000025
2700000090919381818225262627002527000025
27000000a0a1a1a1a1a235363637002527000025
2700000000000000000000000000002527000025
2816161616161616161616161616162927000025
2626262626262626262626262626262627000025
tilesheet castleint
flags indoors
neighborw 100
neighbors 116
sprite 8 4 alphablock_gamma 0 0 0
sprite 11 4 alphablock_lambda 0 0 0
sprite 2 8 treadle gs:ww_fire11 0 0
sprite 16 6 firenozzle_e 2 0 gs:ww_fire11
sprite 17 8 treadle gs:ww_fire11 15 0
