2121212121212121212121212121212121212121
3131313131313131313131313131313131313114
0000000000000000000000000000000000000020
1200030303000300000000000000000000000020
2200000300030300000000000000000000000020
2200000300030300000000000000000000000020
2200000000000000000000000000000000000020
2200000000000000000000000000000000000020
2200000000000000000000000000000000000020
2200000000000000000000000000000000000020
2200000000000000000000000000000000000020
2311111111111111111111111111120000000020
tilesheet castleint
flags indoors
neighborw 100
sprite 8 3 pushblock 0 0 0
sprite 10 3 alphablock_alpha 0 0 0
sprite 12 3 alphablock_gamma 0 0 0
sprite 14 3 alphablock_lambda 0 0 0
sprite 16 3 alphablock_mu 0 0 0
neighbors 116
