1836363636363636363636363636370000000025
2700000000000000000000000000000000000025
2700030303000300000000000000000000000025
2700000300030300000000000000000000000025
2700000300030300000000000000000000000025
2700000000000000000000000000000000000025
3700000000000000000000000000000000000025
0000000000000000000000000000000000000025
0000000000000000000000000000000000000025
0000000000000000000000000000000000000025
0000000000000000000000000000000000000025
1616161616161616161616161616161616161629
tilesheet castleint
flags indoors
neighborn 115
neighborw 117
neighbors 121
