1836363636363636363636363636370000000025
2700000000000000000000000000000000000025
2700030303000300000000000000000000000025
2700000300030300000000000000000000000025
2700000300030300000000000000000000000025
2700000000000000000000000000000000000025
2700000000000000000000000000000000000025
2700000000000000000000000000000000000025
2700000000000000000000000000000000000025
2700000000000000000000000000000000000025
2700000000000000000000000000000000000025
2816161616161616161616161700000015161629
tilesheet castleint
flags indoors
neighborn 115
neighborw 117
neighbors 121
