3636363636363636363636363636363636363619
0000000000000000000000000000000000000025
0000000000000000000000000000000000000025
0000000000000303030003000000000000000025
0000000000000003000303000000000000000025
1616161616161616170303000000000000000025
2626262626262626270000000000000000000025
3636363636363636370000000000000000000025
0000000000000000000000000000000000000025
0000000000000000000000000000000000000025
0000000000000000000000000000000000000025
1616161616161616161616161616161616161629
tilesheet castleint
flags indoors
neighbore 116
neighborn 100
neighborw 118
neighbors 120
sprite 9 7 conveyor 8 0 0
