3131313131313131313131313131313131313114
0000000000000000000000000000000000000020
0000000000000000000000000000000000000020
0000000000000303030003000000000000000020
0000000000000003000303000000000000000020
1200000000000003000303000000000000000020
2200000000000000000000000000000000000030
2200000000000000000000000000000000000000
2200000000000000000000000000000000000000
2200000000000000000000000000000000000000
2200000000000000000000000000000000000000
2311111111111111111111111111111111111111
tilesheet castleint
flags indoors
neighbore 116
neighborn 100
neighborw 118
neighbors 120
sprite 9 7 conveyor 8 0 0
