1836363636363636363636363636363636363636
2700000000000000000000000000000000000000
2700030303000300000000000000000000000000
2700000300030300000000000000000000000000
2700000300030300000000000000000000000000
2700000000000000000000000000000000000015
2700000000000000000000000000000000000025
2700000000000000000000000000000000000025
2700000000000000000000000000000000000025
2700000000000000000000000000000000000025
2700000000000000000000000000000000000025
2700000000151616161616161616161616161629
tilesheet castleint
flags indoors
neighbore 117
neighborn 99
neighbors 119
sprite 9 5 alphablock_alpha 0 0 0
