1331313131313131313131313131313131313131
2200000000000000000000000000000000000000
2200030303000300000000000000000000000000
2200000300030300000000000000000000000000
2200000300030300000000000000000000000000
2200000000000000000000000000000000000010
2200000000000000000000000000000000000020
2200000000000000000000000000000000000020
2200000000000000000000000000000000000020
2200000000000000000000000000000000000020
2200000000000000000000000000000000000020
2200000000101111111111111111111111111124
tilesheet castleint
flags indoors
neighbore 117
neighborn 99
sprite 9 5 alphablock_alpha 0 0 0
neighbors 119
