2700000000353636363636363636363636363619
2700000000000000000000000000000000000025
2700030303000300000000000000000000000025
2700000300030300000000000000000000000025
2700000300030300000000000000000000000025
2700000000000000000000000000000000000025
2700000000000000000000000000000000000025
2700000000000000000000000000000000000025
2700000000000000000000000000000000000025
2700000000000000000000000000000000010025
2700000000000000000000000000000000000025
2816161616161616161616161616161616161629
tilesheet castleint
flags indoors
neighborn 118
neighbore 120
sprite 7 5 conveyor 64 0 0
door 17 9 122 17 9
