2200000000303131313131313131313131313114
2200000000000000000000000000000000000020
2200030303000300000000000000000000000020
2200000300030300000000000000000000000020
2200000300030300000000000000000000000020
2200000000000000000000000000000000000020
2200000000000000000000000000000000000020
2200000000000000000000000000000000000020
2200000000000000000000000000000000000020
2200000000000000000000000000000000010020
2200000000000000000000000000000000000020
2311111111111111111111111111111111111124
tilesheet castleint
flags indoors
neighborn 118
sprite 7 5 conveyor 64 0 0
neighbore 120
door 17 9 122 17 9
