1d3b3b3b3b3b3c0100013a3b3b3b3b3b3b3b3b1e
2c0000030202000200010100030200020001002a
2c0100000000000000000000000000000000022a
2c0000000000000000000000000000000000002a
2c0001020100000000000000000000000000012a
2c0139380200000000000000000000000000022a
2c0004013802000000000000000000000000002a
2c0000380000000000000000000000000000002a
2c0139000300000000000000000000000000022a
2c0039383900000000000000000000000000022a
2c0201010000010000000101040100030000012a
2d1b1b1b1b1b1c0200011a1b1b1b1b1b1b1b1b2e
tilesheet midlands
neighbors 11
neighborn 13
