3636363636363700670035363636363636363619
0200000302020000010001000302000200010025
0201000000000000000000000000000000000225
0200380038000000000000000000000000000025
0200390238000000000000000000000000000125
0201023802000000000000000000000000000225
0200040202020000000000000000000000000025
0200020202000000000000000000000000000025
0201020002000000000000000000000000000225
0200020202000000000000000000000000000225
0202010202020202020202020402020202000125
0202020202020202020202020202020202020225
tilesheet village
neighbors 11
neighborn 13
neighborw 22
