1331313131313131313131313131313131313114
2200000000000000000000000000000000000020
2200000000000000000000000000000000000020
2200000000000000000000020000000000000020
2200000000000000000000000000000000000020
2200000000000000000000000000000000000020
2200000000000000000000000000000000000020
2200000000000000000000000000000000000020
2200000000000000000001000000000000000020
2200000000000000000000000000000000000020
2200000000000000000000000000000000000020
2311111111111111111111111111111111111124
tilesheet castleint
flags indoors
neighborw 119
neighborn 117
neighbore 121
door 11 3 62 11 3
door 10 8 129 10 8
