1836363636363636363636363636363636363619
2700000000000000000000000000000000000025
2700000000000000000000000000000000000025
2700000000000000000000020000000000000025
2700000000000000000000000000000000000025
2700000000000000000000000000000000000025
2700000000000000000000000000000000000025
2700000000000000000000000000000000000025
2700000000000000000001000000000000000025
2700000000000000000000000000000000000025
2700000000000000000000000000000000000025
2816161616161616161616161616161616161629
tilesheet castleint
flags indoors
neighborw 119
neighborn 117
neighbore 121
door 11 3 62 11 3
door 10 8 129 10 8
