1836363636363636363636363700000035363619
2700000000000000000000000000000000000025
2700000000000000000000000000000000000025
2700000000000000000000000000000000000025
2700000000000000000000000000000000000025
2700000000000000000000000000000000000025
3700000000000000000000000000000000000025
0000000000000000000000000000000000000025
0000000000000000000000000000000000000025
0000000000000000000000000000000000000025
1700000000000000000000000000000000000025
2816161616161616161616161616161616161629
tilesheet castleint
flags indoors
neighborw 120
neighborn 116
