1836363636363636363636363636363636363619
2700000000000000000000000000000000000025
2700000000000000000000000000000000000025
2700000000000200000000000000000000000025
2700000000000000000000000000000000000025
2700000000000000000000000000000000000025
2700000000000000000000000000000000000025
2700000000000000000000000100000000000025
2700000000000000000000000000000000000025
2700000000000000000000000000000000000025
2700000000000000000000000000000000000025
2816161616161616161616161616161616161629
tilesheet castleint
flags indoors
neighborw 120
neighborn 116
door 12 7 130 12 7
door 6 3 63 6 3
