2c0000000000000000000000000000000000002a
2c0000000000000000000000000000000000002a
2c0000000000000000000000000000000000002a
2c0000000000000000000000000000000000002a
2c0000000000000000000000000000000000002a
2c0000000000000000000000000000000000002a
2c0000000000000000000000000000000000003a
2c00000000000000000000000000000000000000
2c00000000000000000000000000000000000000
2c00000000000000000000000000000000000000
2c0000000000000000000000000000000000001a
2d1b1b1b1b1b1b1b1b1b1b1b1b1b1b1b1b1b1b2e
tilesheet castleint
flags indoors
neighborn 123
neighbore 129
