2200000000000000000000000000000000000020
2200000000000000000000000000000000000020
2200000000000000000000000000000000000020
2200000000000000000000000000000000000020
2200000000000000000000000000000000000020
2200000000000000000000000000000000000020
2200000000000000000000000000000000000020
2200000000000000000000000000000000000020
2200000000000000000000000000000000000020
2200000000000000000000000000000000020020
2200000000000000000000000000000000000020
2311111111111111111111111111111111111124
tilesheet castleint
flags indoors
neighborn 123
neighbore 129
door 17 9 119 17 9
