2200000000202121212121212121212121212121
2200000000201331313131313131313131313131
2200000000202200000000000000000000000000
2200000000202200000000000000000000000000
2200000000202200000000000000000000000000
2200000000202311111111111111111111111111
2200000000303131313131313131313131313131
2200000000000000000000000000000000000000
2200000000000000000000000000000000000000
2200000000000000000000000000000000000000
2200000000000000000000000000000000000010
2200000000000000000000000000000000000020
tilesheet castleint
flags indoors
neighbors 122
neighborn 124
neighbore 128
sprite 5 3 firenozzle_w 4 0 gs:ww_fire6
sprite 8 3 stompbox gs:ww_fire6 0 0
