2c000000002a2b2b2b2b2b2b2b2b2b2b2b2b2b2b
2c000000002a1d3b3b3b3b3b3b3b3b3b3b3b3b3b
2c000000002a2c00000000000000000404040000
2c000000002a2c00000000040404000404040000
2c000000002a2c00000000040404000000000000
2c000000002a2d1b1b1b1b1b1b1b1b1b1b1b1b1b
2c040404043a3b3b3b3b3b3b3b3b3b3b3b3b3b3b
2c00000000000000000000000000000000000000
2c00000000000000000000000000000000000000
2c00000000000000000000000000000000000000
2d1b1b1b1b1b1b1c00001a1b1b1b1b1b1b1b1b1b
2b2b2b2b2b2b2b2c00002a2b2b2b2b2b2b2b2b2b
tilesheet castleint
flags indoors
neighbors 122
neighborn 124
neighbore 128
sprite 5 3 firenozzle_w 4 0 gs:ww_fire6
sprite 8 3 stompbox gs:ww_fire6 0 0
sprite 12 7 stompbox gs:ww_fire18 0 0
sprite 14 6 firenozzle_s 3 0 gs:ww_fire18
sprite 14 5 firenozzle_n 3 1 gs:ww_fire18
sprite 16 8 pushblock 0 0 0
