2c000000002a2b2b2b2b2b2b2b2b2b2b2b2b2b2b
2c000000002a1d3b3b3b3b3b3b3b3b3b3b3b3b3b
2c000000002a2c00000000000000000000000000
2c000000002a2c00000000000000000000000000
2c000000002a2c00000000000000000000000000
2c000000002a2d1b1b1b1b1b1b1b1b1b1b1b1b1b
2c000000003a3b3b3b3b3b3b3b3b3b3b3b3b3b3b
2c00000000000000000000000000000000000000
2c00000000000000000000000000000000000000
2c00000000000000000000000000000000000000
2c0000000000000000000000000000000000001a
2c0000000000000000000000000000000000002a
tilesheet castleint
flags indoors
neighbors 122
neighborn 124
neighbore 128
sprite 5 3 firenozzle_w 4 0 gs:ww_fire6
sprite 8 3 stompbox gs:ww_fire6 0 0
