3131313131313131313131311421212121212121
0000000000000000000000002021212121212121
0000000000000000000000003031313131313131
0000000000000000000000003300000000000000
0000000000000000101112003300101112000000
1111111111111111242122000000202123111111
1331313131313131313132000000303131313114
2200000000000000000000000000000000000020
2200000000000000000000000000000000000020
2200000000000000000000000000000000000020
2200000000000000000000000000000000000020
2200000000101111111111111111111111111124
tilesheet castleint
flags indoors
neighbors 123
sprite 0 2 firewall 0 0 0
sprite 12 5 chalkguard 0 0 0
sketch 15 6 853504
sketch 16 6 606243
sketch 17 6 857616
sketch 18 6 853507
neighbore 125
