3b3b3b3b3b3b3b3b3b3b3b3b1e2b2b2b2b2b2b2b
0000000000000000000000002a2b2b2b2b2b2b2b
0000000000000000000000003a3b3b3b3b3b3b3b
0000000000000000000000003d00000000000000
00000000000000001a1b1c003d001a1b1c000000
1b1b1b1b1b1b1b1b2e2b2c0000002a2b2d1b1b1b
1d3b3b3b3b3b3b3b3b3b3c0000003a3b3b3b3b1e
2c0000000000000000000000000000000000002a
2c0000000000000000000000000000000000002a
2c0000000000000000000000000000000000002a
2c0000000000000000000000000000000000002a
2c000000001a1b1b1b1b1b1b1b1b1b1b1b1b1b2e
tilesheet castleint
flags indoors
neighbors 123
neighbore 125
sketch 15 6 853504
sketch 16 6 606243
sketch 17 6 857616
sketch 18 6 853507
sprite 0 2 firewall 0 0 0
sprite 12 5 chalkguard 28 29 0
