2121212121212121212121212121212121212121
2121212121212121212121212121212121212121
3131313131313131142121133131313131313131
0000000000000000202121220000000000000000
0000000000000000202121220000000000000000
1111111111111200202121220010111111111111
2121212121212200202121220020212121212121
2121212121212200303131320020212121212121
2121212121212200000000000020212121212121
2121212121212311111111111124212121212121
2121212121212121212121212121212121212121
2121212121212121212121212121212121212121
tilesheet castleint
flags indoors
neighborw 124
sprite 13 8 firenozzle_w 6 0 gs:ww_tw1
sprite 9 8 treadle gs:ww_tw1 0 0
neighbore 126
neighbors 128
