2121212121212121212121212121212121212121
2121212121212121212121030303210321212121
3131313131311421212121210321030321212121
0000000000002021212121210321030321212121
0000000000002021212121212121212121212121
1111111112002021212121212121212121212121
2121212122003031313131311421212121212121
2121212122000000000000002021212121212121
2121212123111111111200002021212121212121
2121212121212121212200002021212121212121
2121212121212121212200002021212121212121
2121212121212121212200002021212121212121
tilesheet castleint
flags indoors
neighborw 125
neighbors 127
