2b2b2b2b2b2b2b2b2b2b2b2b2b2b2b2b2b2b2b2b
2b2b2b2b2b2b2b2b2b2b2b2b2b2b2b2b2b2b2b2b
3b3b3b3b3b3b1e2b2b2b2b2b2b2b2b2b2b2b2b2b
0000000000002a2b2b2b2b2b2b2b2b2b2b2b2b2b
0000000000002a2b2b2b2b2b2b2b2b2b2b2b2b2b
1b1b1b1b1c002a2b2b2b2b2b2b2b2b2b2b2b2b2b
2b2b2b2b2c003a3b3b3b3b3b1e2b2b2b2b2b2b2b
2b2b2b2b2c000000000000002a2b2b2b2b2b2b2b
2b2b2b2b2d1b1b1b1b1c00002a2b2b2b2b2b2b2b
2b2b2b2b2b2b2b2b2b2c00002a2b2b2b2b2b2b2b
2b2b2b2b2b2b2b2b2b2c00002a2b2b2b2b2b2b2b
2b2b2b2b2b2b2b2b2b2c00002a2b2b2b2b2b2b2b
tilesheet castleint
flags indoors
neighborw 125
neighbors 127
sprite 12 7 firenozzle_w 7 1 gs:ww_fire7
sprite 8 6 tripwire gs:ww_fire7 0 0
sprite 5 2 firenozzle_s 5 10 0
