2b2b2b2b2b2b2b2b2b2b2b2b2b2b2b2b2b2b2b2b
2b2b2b2b2b2b2b2b2b2b2b0303032b032b2b2b2b
3b3b3b3b3b3b1e2b2b2b2b2b032b03032b2b2b2b
0000000000002a2b2b2b2b2b032b03032b2b2b2b
0000000000002a2b2b2b2b2b2b2b2b2b2b2b2b2b
1b1b1b1b1c002a2b2b2b2b2b2b2b2b2b2b2b2b2b
2b2b2b2b2c003a3b3b3b3b3b1e2b2b2b2b2b2b2b
2b2b2b2b2c000000000000002a2b2b2b2b2b2b2b
2b2b2b2b2d1b1b1b1b1c00002a2b2b2b2b2b2b2b
2b2b2b2b2b2b2b2b2b2c00002a2b2b2b2b2b2b2b
2b2b2b2b2b2b2b2b2b2c00002a2b2b2b2b2b2b2b
2b2b2b2b2b2b2b2b2b2c00002a2b2b2b2b2b2b2b
tilesheet castleint
flags indoors
neighborw 125
neighbors 127
