1331313131313131313200003031313131142121
2200000000000000000000000000000000202121
2200000000000000000000000000000000202121
2200000000000000000000000000000000202121
2200000000000000000010111200000000202121
2200030303000300000020212200000000202121
2200000300030300000020212200000000202121
2200000300030300000020212200000000202121
2200000000000000000020212200000000202121
2200000000000000000020212200000000202121
2200000000000000000020212200000000202121
2311111111111111111124212200000000202121
tilesheet castleint
flags indoors
neighborn 126
neighborw 128
neighbors 130
