2b2b2b2b2b2b2b2b2b2b2b2b2b2b2b2b2b2b2b2b
3b3b3b3b3b3b3b3b3b3b3b3b3b3b3b3b3b3b3b1e
000000000000000000808181820000000000002a
000000000000000000909191920000000000002a
000000000000000000909191920000000000002a
1b1b1b1b1c00000000909191920060616200002a
3b3b3b3b3c000000009091919200707172737374
000000000000000000909191920000000000002a
000000000000000000909191920000000000002a
000000000000000000a0a1a1a20000000000002a
1b1b1b1b1b1b1b1b1b1b1b1b1b1b1b1b1b1b1b2e
2b2b2b2b2b2b2b2b2b2b2b2b2b2b2b2b2b2b2b2b
tilesheet castleint
flags indoors
neighbore 127
neighborn 125
neighborw 123
neighbors 129
sprite 15 5 otp 0 gs:ww_otp_20bits 0
sprite 11 4 seamonster 0 0 0
sprite 10 7 seamonster 0 0 0
sprite 4 7 bonfire 0 0 0
sprite 2 4 bonfire 0 0 0
sprite 6 5 bonfire 0 0 0
