2121212121212121212121212121212121212121
3131313131313131313131313131313131313114
0000000000000000000000000000000000000020
0000000000000000000000000000000000000020
0000000000000000000000000003030300030020
1111111112000000000000000000030003030020
3131313132000000000000000000030003030020
0000000000000000000000000000000000000020
0000000000000000000000000000000000000020
0000000000000000000000000000000000000020
1111111111111111111111111111111111111124
2121212121212121212121212121212121212121
tilesheet castleint
flags indoors
neighbore 127
neighborn 125
neighborw 123
neighbors 129
