1d3b3b3b3b3b3b3b3b3b3b3b3b3b3b3b3b3b3b1e
2c0000000000000000000000000000000000002a
2c0000000000000000000000000000000000002a
2c0000000000000000000000000000000000002a
2c0000000000000000000000000000000000002a
2c0000000100000000000000000000000000002a
2c0000000000000000000000000000000000002a
2c0000000000000000000000000000000000002a
2c0000000000000000000200000000000000002a
2c0000000000000000000000000000000000002a
2c0000000000000000000000000000000000002a
2d1b1b1b1b1b1b1b1b1b1b1b1b1b1b1b1b1b1b2e
tilesheet castleint
flags indoors
neighborn 128
neighborw 122
neighbore 130
door 10 8 120 10 8
door 4 5 102 4 5
