1d3b3b3b3b3b3c00000000013a3b3b3b3c252626
2c00000000020101000000000100020000252626
2c04000000000000000000000000000000252626
3c00000000000000000000000000000000351926
0101010000000000000000000000000001022526
01003e3e02000000000000000000000000012526
03003d0101000000000000000000000000002526
1c013e3d00000000000000000000000000023536
2c003d0300000000000000000000000000010201
2c003e0000000000000000000000000000000002
2c00000101010101000000030100030004000300
2d1b1b1b1b1b1b1c0400021a1b1b1b1b1b1b1b1b
tilesheet forest
song toil_and_trouble
neighbore 15
neighborn 2
neighbors 14
neighborw 39
