1d3b3b3b3b3b3c00000000013a3b3b3b3b3b3b1e
2c0000000002010100000000010002000100002a
2c0400000000000000000000000000000000033a
3c00000000000000000000000000000000000001
0101010000000000000000000000000000000000
01003e3e02000000000000000000000000000000
03003d0101000000000000000000000000000000
1c013e3d00000000000000000000000000000000
2c003d030000000000000000000000000000011a
2c003e000000000000000000000000000000002a
2c0000030000000000000000000203000400022a
2d1b1b1c0100000000000000001a1b1b1b1b1b2e
tilesheet forest
song toil_and_trouble
neighbore 15
neighborn 2
neighbors 14
neighborw 39
