1d3b3b3b3b3b3c0000043a3b3b3b3b3b3b3b3b1e
2c0301010200000001000102010000010100002a
2c0000000000000000000000000000000000022a
2c0000000000000000000000000000000000002a
2c0203000300000000000000000000000000032a
2c0038390200000000000000000000000000012a
2c0000390200000000000000000000000000022a
2c0000380000000000000000000000000000012a
2c0001390401000000000000000000000000022a
2c0138393901000000000000000000000000032a
2c0001000002020300010100010101000000012a
2d1b1b1b1b1b1c0000001a1b1b1b1b1b1b1b1b2e
tilesheet midlands
neighbors 12
neighborn 14
