2121212121212121212121212200000000202121
2113313131313131313131313200000000202121
2122000000000000000000000000000000202121
2122000000000000000000000000000000202121
2122000000000000000000000000000000202121
2122000000000000000000000000000000202121
2122000000000000000000000000000000202121
2122000000000000000000000200000000202121
2122000000000000000000000000000000202121
2122000000000000000000000000000000202121
2123111111111111111111111111111111242121
2121212121212121212121212121212121212121
tilesheet castleint
flags indoors
neighborw 129
neighborn 127
door 12 7 121 12 7
