3b3b3b3b3b1e2b2b2b2b2b2b2c000000002a2b2b
00000000002a2b2b2b2b2b2b2c000000002a2b2b
00000000002a2b2b2b2b2b2b2c000000002a2b2b
00000000003a3b3b3b3b3b3b3c000000002a2b2b
1b1c0000000000000000000000000000002a2b2b
2b2c0000000000000000000000000000002a2b2b
2b2c0000000000000000000000000000002a2b2b
2b2c00000000001a1b1c000000000000002a2b2b
2b2c00000000003a3b3c000000000000002a2b2b
2b2c0000000000000000000000000000002a2b2b
2b2d1b1b1b1b1b1b1b1b1b1b1b1b1b1b1b2e2b2b
2b2b2b2b2b2b2b2b2b2b2b2b2b2b2b2b2b2b2b2b
tilesheet castleint
flags indoors
neighborw 129
neighborn 127
sprite 8 5 throwswitch gs:ww_fire19 0 0
sprite 7 3 firenozzle_s 3 0 0
sprite 9 3 firenozzle_s 3 0 0
sprite 11 3 firenozzle_s 6 0 gs:ww_fire19
sprite 6 3 firenozzle_s 6 1 gs:ww_fire19
sprite 1 7 firenozzle_e 5 0 gs:ww_fire20
sprite 13 8 treadle gs:ww_fire20 10 0
