1d3b3b3b3b3b3b3b3b3b3b3b3b3b3b3b3b3b3b3b
2c00000000000000000000000000000000000000
2c00000000000002000000000000000000000000
2c00000000000000000000000000000000000000
2c00000000000000000000000000000000000000
2c00000000000000000000000000000000000000
2c00000000000000000000000000000000000000
2c00000000000000000000000000000000000000
2c00000000000000000000000000000000000000
2c00000000000000000000000000000000000000
2c00000000000000000000000000000000000000
2c00000000000000000000000000000000000000
tilesheet caves
neighbore 133
neighbors 135
door 7 2 51 7 2
