1d3b3b3b3b3b3b3b1e1d3b3b3b3b3b3b3b3b3b3b
2c000000000000003a3c00000000000000000000
2c0000001a1b1c00000000041a1b1b1b1b1b1b1b
2c0004002a2b2d1c000000042a2b1d3b1e2b2b2b
2d1c00003a1e2b2c000400042a2b2c003a1e2b2b
2b2d1c00002a2b2c000000003a1e2c00002a2b2b
2b2b2d1b1b2e2b2c04000000002a2c00003a3b3b
2b1d3b3b1e2b1d3c04000404042a2c0000000000
1d3c00003a3b3c0000000000002a2d1c00000000
2c0000000000000004040400003a1e2d1c000000
2c000000000000000000000000003a1e2d1c0000
2c00001a1b1b1b1b1b1b1b1c0000002a2b2d1b1b
tilesheet caves
flags dark
neighbore 133
neighbors 135
sprite 2 2 hattroll 0 0 0
sprite 6 1 hattroll 0 0 0
sprite 6 9 hattroll 0 0 0
sprite 11 5 hattroll 0 0 0
sprite 16 5 hattroll 0 0 0
