3b3b3b3b3b3b3b3b3b3b3b3b3b1e1d3b3b3b3b1e
000000000000000000000000002a2c000000002a
1b1b1c00001a1b1b1b1c001a1b2e2c000000002a
1d3b3c00002a2b1d3b3c002a1d3b3c000000002a
2c000000003a3b3c0000002a2c0000000000002a
2c001a1c000000000000002a2c0000000000002a
3c002a2c000000001a1b1b2e2c00001a1c00002a
00002a2c001a1b1b2e1d3b3b3c00002a2c00003a
00002a2c003a3b3b3b3c00000000002a2c000000
00002a2c00000000000000001a1c002a2c000000
001a2e2c00000000000000002a2c002a2c000000
1b2e2b2d1b1b1b1b1b1b1b1b2e2d1b2e2d1b1b1b
tilesheet caves
flags dark
neighborw 132
neighbore 134
neighbors 136
sprite 4 3 hattroll 0 0 0
sprite 8 4 hattroll 0 0 0
sprite 6 6 hattroll 0 0 0
sprite 10 9 hattroll 0 0 0
sprite 14 4 hattroll 0 0 0
sprite 17 5 hattroll 0 0 0
