2b1d3b3b3b1e2b2b1d3b3b3b1e2b2b2b2b2b2b2b
1d3c0000003a1e1d3c0000003a3b1e2b2b2b2b2b
2c00000000002a2c0000000000002a2b2b2b2b2b
2c00000000002a2c0000000000003a1e2b2b2b2b
2c00000000002a2d1011121c0000002a2b2b2b2b
2d1b1b1011122e2b2021222c0000002a2b2b2b2b
2b2b2b2021222b1d3b3b3b3c0000002a2b2b2b2b
3b3b3b3b3b3b3b3c0000000000001a2e2b2b2b2b
000000000000000000001a1b1b1b2e2b2b2b2b2b
0000000000000000001a2e2b2b2b2b2b2b2b2b2b
00000000000000001a2e2b2b2b2b2b2b2b2b2b2b
1b1b1c00001a1b1b2e2b2b2b2b2b2b2b2b2b2b2b
tilesheet caves
flags dark
neighborw 133
neighbors 137
door 4 5 47 4 5
door 9 4 47 9 4
sprite 2 3 stompbox gs:mtn_fire2 0 0
sprite 2 7 firenozzle_s 3 0 gs:mtn_fire2
sprite 4 5 doorhere 0 0 0
sprite 9 4 doorhere 0 0 0
