2b2b2b2b2b1d3b3b3b3b3b1e2b2b2b2b2b2b2b2b
3b3b3b3b3b3c00000000003a3b1e2b2b2b2b2b2b
000000000000000000000000002a2b2b2b2b2b2b
000000000000000000000000002a2b2b2b2b2b2b
1b1b1b1b1b1b1c00000000001a2e2b2b2b2b2b2b
2b2b2b2b2b2b2d1b1011121b2e2b2b2b2b2b2b2b
2b2b2b2b2b2b2b2b2021222b2b2b2b2b2b2b2b2b
3b3b3b3b1e2b1d3b3b3b3b3b3b1e2b2b2b2b2b2b
000000003a3b3c0000000000003a3b1e2b2b2b2b
0000000000000000001a1c000000002a2b2b2b2b
00000000000000001a2e2c000000002a2b2b2b2b
1b1b1b1b1b1b1b1b2e2b2c000000002a2b2b2b2b
tilesheet caves
flags dark indoors
neighborw 135
neighborn 133
neighbore 137
neighbors 139
door 9 5 49 9 5
sprite 9 5 doorhere 0 0 0
sprite 5 9 rat 0 0 0
