2b1d3c00002a2b2b1d3b3b3b3b3b3b3b3b3b3b1e
1d3c0000002a2b1d3c000000000000000000002a
2c0000001a2e1d3c00001a1b1c000000003e002a
2c0000002a1d3c0000003a1e2d1b1b1c0000002a
2c001a1b2e2c00000000003a3b3b3b3c0000002a
2c003a3b1e2d1011121c0000000000000000002a
2c0000002a2b2021222d1b1c000000003e00002a
2d1c00003a3b3b3b1e2b2b2d1b1c00000000002a
2b2c0000000000003a3b1e2b2b2d1b1c0000002a
2b2d1b1b1b1c000000003a3b1e2b2b2c0000002a
2b2b2b2b2b2d1c00000000002a2b2b2c003e002a
2b2b2b2b2b2b2d1b1c0000002a2b2b2c0000002a
tilesheet caves
flags dark
neighborw 136
neighborn 134
neighbors 140
door 7 5 46 7 5
