2c00000000000000000000000000000000000000
2c00000000000000000000000000000000000000
2d1c000000000000000000000000000000000000
2b2c000000000000000000000000000000000000
2b2c000000000000000000000000000000000000
2b2c000000000000000000000000000000000000
1d3c000000000000000000000000000000000000
2c00000000000000000000000000000000000000
2c00000000000000000000000000000000000000
2c00000000000000000000000000000000000000
2c00000000000000000000000000000000000000
2d1b1b1b1b1b1b1b1b1b1b1b1b1b1b1b1b1b1b1b
tilesheet caves
neighborn 135
neighbore 139
