3b3b3b3b3b1e2b2b1d3b3c000000003a3b3b3b3b
00000000002a2b2b2c0000000000000000001516
001a1011122e2b2b2c001a1b1c00001a1c003519
1b2e2021222b2b2b2d1b2e1d3c001a2e2c000035
2b2b2b2b2b1d3b3b3b3b3b3c00002a2b2d1c001a
2b2b2b2b1d3c00000000000000003a3b3b3c002a
2b2b1d3b3c1517001a1b1b1b1c0000000000002a
2b2b2c15162927003a3b3b1e2d1b1b1b1b1b1b2e
2b2b2c35363637000000003a3b3b3b3b3b3b3b3b
2b2b2d1b1b1b1b1b1c0000000000000000000000
2b2b2b2b2b2b2b2b2c0000000000000000000000
2b2b2b2b2b2b2b2b2d1b1b1b1b1b1b1b1b1b1b1b
tilesheet caves
flags dark
neighborw 138
neighborn 136
neighbore 140
door 3 2 4 3 2
sprite 3 2 doorhere 0 0 0
