3b3b3b3b3b1e2b2b1d3b3c000000003a3b3b3b3b
00000000002a2b2b2c0000000000000000000000
001a1011122e2b2b2c0000000000000000000000
1b2e2021222b2b2b2c0000000000000000000000
2b2b2b2b2b2b2b2b2c0000000000000000000000
2b2b2b2b2b2b2b2b2c0000000000000000000000
2b2b2b2b2b2b2b2b2c0000000000000000000000
2b2b2b2b2b2b2b2b2c0000000000000000000000
2b2b2b2b2b2b2b2b2c0000000000000000000000
2b2b2b2b2b2b2b2b2c0000000000000000000000
2b2b2b2b2b2b2b2b2c0000000000000000000000
2b2b2b2b2b2b2b2b2d1b1b1b1b1b1b1b1b1b1b1b
tilesheet caves
flags dark
neighborw 138
neighborn 136
neighbore 140
door 3 2 4 3 2
