1d3b3b3b3b3b3b3b3b3b3b3b3b3b3b3b3b3b3b1e
2c0000000100040200000001000200000200012a
2c0400000000000000000000000000000000002a
2c0100000000000000000000000000000000002a
2c0000000102000000000000000000000000022a
2c0038393901000000000000000000000000002a
2c0338003801000000000000000000000000002a
2c0038023801000000000000000000000000042a
2c0038003801000000000000000000000000012a
2c0139393901000000000000000000000000002a
2c0100000101000000000000000300020000002a
2d1b1b1b1b1b1c0000011a1b1b1b1b1b1b1b1b2e
tilesheet midlands
neighbors 13
