1d3b3b3c0000000000000000013a3b3b3b3b3b1e
2c0001010000000000000000000000010200012a
2c0100000000000000000000000000000000003a
2c01000000000000000000000000000000000001
2c01000000000000000000000000000000000000
2c003e3d02000000000000000000000000000000
2c003d0100000000000000000000000000000000
2c003e3d0400000000000000000000000000001a
2c003e030000000000000000000000000000022a
2c003d000000000000000000000000000000002a
2c0201000400020002000001010300000000002a
2d1b1b1b1b1b1b1b1b1b1b1b1b1b1b1b1b1b1b2e
tilesheet forest
song toil_and_trouble
neighborn 13
neighbore 16
neighbors 18
neighborw 38
