3b3b1e2b2b2b2b2b2c0000002a2b2b2c0000002a
00003a3b1e2b2b2b2c0000002a2b2b2c0000002a
000000002a2b2b2b2c0000002a2b2b2d1c00002a
000000003a1e2b2b2d1c00002a2b2b1d3c00002a
00000000003a1e2b2b2c00002a2b2b2c0000002a
0000000000003a1e1d3c00003a1e2b2c00041a2e
000000000000002a2c000000003a3b3c00002a2b
000000000000002a2c0000040000000000002a2b
000000000000002a2d1c00000000000000002a2b
0000000000001a2e2b2d1c00001a1b1c00002a2b
0000001a1b1b2e2b2b2b2d1b1b2e2b2d1b1b2e2b
1b1b1b2e2b2b2b2b2b2b2b2b2b2b2b2b2b2b2b2b
tilesheet caves
flags dark
neighborw 139
neighborn 137
sprite 14 6 firenozzle_s 2 0 gs:mtn_fire1
sprite 5 7 stompbox gs:mtn_fire1 0 0
