2b2b2b2b2b2b2b2b2b2b2b2b2b2b2b2b2b2b2b2b
2b2b2b2b2b2b2b2b2b1d3b3b3b3b3b3b3b3b3b3b
2b2b2b2b1d3b3b3b3b3c15161616161616161616
2b2b1d3b3c151616161629262626262626262626
3b3b3c1516292626262626262626262626262626
1616162926262626183636361926183636361926
2626262618363636371a1b1c2526271a1b1c3536
26261836371a1b1b1b2e2b2c2526272a2b2d1b1b
3636371a1b2e2b2b2b2b2b2c2526272a2b2b2b2b
1b1b1b2e2b2b2b2b2b2b2b2c2526272a2b2b2b2b
2b2b2b2b2b2b2b2b2b2b2b2c2526272a2b2b2b2b
2b2b2b2b2b2b2b2b2b2b2b2c2526272a2b2b2b2b
tilesheet caves
flags multihome indoors
neighbore 141
neighborw 143
neighbors 144
