2b2b2b2b2b2b2b2b2b2b2b2b2b2b2b2b2b2b2b2b
2b2b2b2b2b2b2b2b68692b2b2b2b2b2b2b2b2b2b
2b2b2b2b2b2b1d3b78793b1e2b2b2b2b2b2b2b2b
2b2b2b2b2b2b2c000000003a3b1e2b2b2b2b2b2b
2b2b2b2b2b2b2c0000000000002a2b2b2b2b2b2b
2b2b2b2b2b1d3c0000000000002a2b2b2b2b2b2b
2b2b2b2b2b2c020000000000002a2b2b2b2b2b2b
2b2b2b2b2b2d1b1b1b1b1b1b1b2e2b2b2b2b2b2b
2b2b2b2b2b2b2b2b2b2b2b2b2b2b2b2b2b2b2b2b
2b2b2b2b2b2b2b2b2b2b2b2b2b2b2b2b2b2b2b2b
2b2b2b2b2b2b2b2b2b2b2b2b2b2b2b2b2b2b2b2b
2b2b2b2b2b2b2b2b2b2b2b2b2b2b2b2b2b2b2b2b
tilesheet caves
flags dark indoors
door 6 6 103 6 6
