2b2b2b2b2b2b2b2b2b2b2b2b2b2b2b2b2b2b2b2b
2b2b1d3b3b3b3b3b3b3b3b3b3b3b3b3b3b1e2b2b
3b3b3c04040404040404040404040404043a3b3b
0000000000000000000000000000000000000000
0000000000000000000000000000000000000000
1b1b1c04040404040404040404040404041a1b1b
2b2b2d1b1b1b1b1b1b1b1b1b1b1b1b1b1b2e2b2b
2b2b2b2b2b2b2b2b2b2b2b2b2b2b2b2b2b2b2b2b
2b2b2b2b2b2b2b2b2b2b2b2b2b2b2b2b2b2b2b2b
2b2b2b2b2b2b2b2b2b2b2b2b2b2b2b2b2b2b2b2b
2b2b2b2b2b2b2b2b2b2b2b2b2b2b2b2b2b2b2b2b
2b2b2b2b2b2b2b2b2b2b2b2b2b2b2b2b2b2b2b2b
tilesheet castleint
flags ancillary blowback
neighbors 147
