2b2b2b2b2b2b2b2b2b2b2b2b2b2b2b2b2b2b2b2b
2b2b1d3b3b3b3b3b3b3b3b3b3b3b3b3b3b1e2b2b
3b3b3c00000000000000000000000000003a3b3b
0000000000000000000000000000000000000000
0000000000000000000000000000000000000000
1b1b1c00000000000000000000000000001a1b1b
2b2b2d1b1b1b1b1b1b1b1b1b1b1b1b1b1b2e2b2b
3b3b3b3b3b3b3b3b3b3b3b3b3b3b3b3b3b3b3b3b
0505050505050505050505050505050505050505
0505050505050505050505050505050505050505
0505050505050505050505050505050505050505
1b1b1b1b1b1b1b1b1b1b1b1b1b1b1b1b1b1b1b1b
tilesheet castleint
flags ancillary
neighbors 147
