2626262626262626262626262626262626262626
2626183636363636363636363636363636192626
3636370000000000000000000000000000353636
0000000000000000000000000000000000000000
0000000000000000000000000000000000000000
1616170000000000000000000000000000151616
2626281616161616161616161616161616292626
3636363636363636363636363636363636363636
0000000000000000000000000000000000000000
0000000000000000000000000000000000000000
0000000000000000000000000000000000000000
1616161616161616161616161616161616161616
tilesheet castleint
neighborn 146
neighbors 148
