262626262626262626183636363636374b4c4d4e
26261836363636363637000000edeeef5b5c5d5e
36363700000000000000000000fdfeff6b6c6d6e
0000000000000000000000000000000000000000
0000000000000000000000000000000000000000
1616170000000000000000000000000000151616
2626281616161616161616161616161616292626
2626262626262626262626262626262626262626
2626262626262626262626262626262626262626
2626262626262626262626262626262626262626
2626262626262626262626262626262626262626
2626262626262626262626262626262626262626
tilesheet castleint
neighborn 146
neighbors 148
