2121212121212121212121212121212121212121
2121133131313106313131310731313131142121
3131320000000000000000000000000000303131
0000000000000000000000000000000000000000
0000000000000000000000000000000000000000
1111120000000000000000000000000000101111
2121231111111111111111111111111111242121
2121212121212121212121212121212121212121
2121212121212121212121212121212121212121
2121212121212121212121212121212121212121
2121212121212121212121212121212121212121
2121212121212121212121212121212121212121
tilesheet castleint
neighborn 147
neighbors 149
