48494a48494a48494a48494a48494a48494a4849
58595ad0d1d2d3d45a58595a58595a58595a5859
000100e0e1e2e3e4030000010400010001000001
010102f0f1f2f3f4000102010101000200000300
0102000002019394950002000102000100000200
0300000201010200010302020003030200000100
1b1b1b1b1b1b1b1b1b1b1b1b1b1b1b1b1b1b1b1b
2b2b2b2b2b2b2b2b2b2b2b2b2b2b2b2b2b2b2b2b
3b3b3b3b3b3b3b3b3b3b3b3b3b3b3b3b3b3b3b3b
0000020100000000020000010000000000000002
0001020101020002000000010300000000010201
1b1b1b1b1b1b1b1b1b1b1b1b1b1b1b1b1b1b1b1b
tilesheet forest
flags blowback
neighborn 148
neighbors 150
