2c0300020100252627000000013a1e2b2c252626
2c020004010025262701010002012a2b2c252626
3c010000000025262700000000023a1e2c252626
0401000000012526270300000000002a2c351926
0000010101003536370400000002012a2d1c2526
0100393901010301000000000000002a2b2c2526
02023800000000000000000002001a2e2b2c2526
01043839040100000000000102012a2b2b2c3536
1c0038040103000000000001011a2e2b2b2d1b1b
2c00390302020000000000011a2e2b2b2b2b2b2b
2c000302030000010003001a2e2b2b2b2b2b2b2b
2d1b1b1b1b1b1c0000011a2e2b2b2b2b2b2b2b2b
tilesheet forest
song toil_and_trouble
neighborn 1
neighbors 16
neighborw 13
neighbore 24
