2c0300020100252627000000042a2b2c25262626
2c0200040100252627010100012a2b2c25262626
2c0000000000252627000000022a2b2c25262626
2c0000000001252627030000002a2b2c25262626
2c0000000101353637040000012a2b2c25262626
2c0339393901030100000000013a1e2c25262626
2c003900030000000000000000002a2c25262626
2c023938030100000000000102012a2c35192626
2c0000003902000000000001011a2e2d1c351926
2c01393901000000000000011a2e2b2b2d1c3536
2c030102000000010003001a2e2b2b2b2b2d1b1b
2d1b1b1b1b1b1c0000011a2e2b2b2b2b2b2b2b2b
tilesheet midlands
neighborn 1
neighbors 16
