2ba3a41f0d0e2b2c6d6e7576c3c41f2a2b2c2b2b
3bb3b42f1d1e3b3c3d3e3b3cd3d42f3a3b3c3b3b
1111111200000000c5c67f7c0000000000000000
3131142311120000d5d62f6f0000000010111111
4546301421231111111111111111111124133131
5556003031313131313131313131313131320000
6566000000000000000000000000000000000000
f2f3f1f2f3f4f2f3f4f2f3f4f2f3f4f2f3f4f2f3
0000000000000000000000000000000000000000
0000000000000000000000000000000000000000
0000000000000000000000000000000000000000
0000000000000000000000000000000000000000
tilesheet village
flags blowback
neighborn 149
sprite 6 2 billy 0 0 0
sprite 7 2 janie 0 0 0
