010101011011121314151c1d18191a1b01010101
010101012021222324252c2d283c3d2b01010101
010101013031323334353637384c4d3b01010101
01010101404142434445464748494a4b01010101
01010101505152535455565758595a5b01010101
01010101606162636465666768696a6b01010101
01010101707172737475767778797a7b01010101
01010101808182838485868788898a8b01010101
0101010101010101010101010101010101010101
0101010101010101010101010101010101010101
0101010101010101010101010101010101010101
0101010101010101010101010101010101010101
tilesheet dots
flags ancillary
