2c0103252627030100003a3b3b3b3b3b3b3b3b1e
2c0100252628161703010100010200000302002a
3c0200252626262701000068696a02030002023a
000001353619262700000178797a010001040100
020000000225262701000488898a010000010201
0401020000060606000103000002010000000102
0201000100252628170000030302000000030202
1c00020000351926281703040002444501010200
2c01010100002526262816170000545500010301
2c0201000000351926262628170003030000021a
2c0000000001033536361926270200000102012a
2d1b1b1b1b1b1b1b1b1c2526271a1b1b1b1b1b2e
tilesheet forest
saveto spell:HOME
neighborn 15
neighbors 17
neighborw 14
neighbore 25
song toil_and_trouble
