1d3b3b3b3b3b3c0100003a3b3b3b3b3b3b3b3b1e
2c0000010000000100010201000000010002002a
3c0200000000000000000000000000000000023a
0000000001000000000000000000000000000100
0204030300000000000000000000000000000201
04003d3d00000000000000000000000000000102
02013e0400000000000000000000000000000202
1c003d3d00000000000000000000000000000200
2c003e0102020000000000000000000000000301
2c003e000000000000000000000000000000021a
2c0000000000000200020100000300000102012a
2d1b1b1b1b1b1b1b1b1b1b1b1b1b1b1b1b1b1b2e
tilesheet forest
song toil_and_trouble
neighborn 15
neighbors 17
neighborw 14
neighbore 25
