1d3b3b3b3b3b3c0100003a3b3b3b3b3b3b3b3b1e
2c0000010000000100010201000000010002002a
2c0000000000000000000000000000000000022a
2c0000000000000000000000000000000000022a
2c0200390000000000000000000000000000002a
2c0038000200000000000000000000000000022a
2c0239380403000000000000000000000000002a
2c0038003800000000000000000000000000042a
2c0101390200000000000000000000000000002a
2c0001030000000000000000000000000000002a
2c0100030000020100010200000300000102012a
2d1b1b1b1b1b1c0101001a1b1b1b1b1b1b1b1b2e
tilesheet midlands
neighborn 15
neighbors 17
