2b2b2b2b2b2b2c2526272a2b2b2b2b2b2b2b2b2b
2b2b2b2b2b2b2c2526272a2b2b2b2b2b2b2b2b2b
2b2b2b2b2b2b2c2526272a2b2b2b2b2b2b2b2b2b
2b2b2b2b2b1d3c2526272a1d3b3b3b1e2b2b2b2b
2b2b2b2b1d3c012526273a3c0002023a3b3b1e2b
2b2b2b2b2c000325262700000202030000003a3b
2b2b2b1d3c010006060601020000000000020200
3b3b3b3c01010025262702021516170101030103
0203010101151629262816162926281617010303
1616161616292626262626262626262628161616
2626262626262626262626262626262626262626
2626262626262626262626262626262626262626
tilesheet beach
song eye_of_newt
neighborn 16
neighborw 18
neighbore 19
neighbors 87
sprite 8 6 tolltroll 0 0 0
