2b2b2b2b2b2b2b2b2b2b2b2b2b2b2b2b2b2b2b2b
2b2b2b2b2b2b2b2b2b2b2b2b2b2b2b2b2b2b2b2b
2b2b2b2b2b2b2b2b2b2b2b2b2b2b2b2b2b2b2b2b
2b2b2b2b2b2b2b2b2b2b2b1d3b3b3b1e2b2b2b2b
2b2b2b2b2b2b2b2b2b1d3b3c0002023a3b3b1e2b
2b2b2b2b2b1d3b3b3b3c02000202030000003a3b
2b2b2b1d3b3c0301000302030100000000020200
3b3b3b3c03010102000301151616170101030103
0203010101151616161616292626281617010303
1616161616292626262626262626262628161616
2626262626262626262626262626262626262626
2626262626262626262626262626262626262626
tilesheet beach
song eye_of_newt
neighborn 16
neighborw 18
neighbore 19
neighbors 87
