3b3b3b3b3b3b3b3b3b3b3b3b3b3b3b3b1e2b2b2b
000000000001030000000000000200003a1e2b2b
00000002000201010000010200000002002a2b2b
03000003010002020000010200000003032a2b2b
00000000000000030000000003000303003a1e2b
0000000000000300020002000300000002022a2b
0300000000000302000000020300020001023a1e
000002000000000000000002010202010200003a
0000000000020000000000000000000002000000
0000000001008081828283838384000000001516
0000000000029093929293939194000115162926
4141414141414141414141414215161629262626
tilesheet swamp
song gloom_for_company
neighbore 17
neighborn 14
neighborw 37
neighbors 88
