3b3b3b3b3b3b3b3b3b3b3b3b3b3b3b3b1e2b2b2b
7aaaab020001030000000000000200003a1e2b2b
9b030102000203030000000200000002003a3b3b
0203000301000040414200020000000100040404
0000000000004054436200000300030304040404
0003000000006061620300000100030004040404
4142000000010003000003630000000404040404
5153420000000000000002000300000404040404
5151534200000000000000000000040404040404
5151515342008081828283838384040404041516
5151515153429093929293939194040415162926
5151515151534141414141414215161629262626
tilesheet swamp
saveto spell:TELE2
neighbore 17
neighborn 14
neighborw 37
neighbors 88
song gloom_for_company
