3b3b3b3b3b3b3b3b3b3b3b3b3b3b3b3b1e2b2b2b
000000000000000000000000000000023a1e2b2b
00000000000000000000000000000002022a2b2b
00000000000000000000000000000002022a2b2b
00000000000000000000000000000002023a1e2b
0000000000636400000000000000000202022a2b
0000000000640000000000000000000202023a1e
000000006464000000000000000000020202023a
0000000000000000000000000000000202020202
0000000000000000000000000000000202021516
0000000000000000000000000002010315162926
4141414141414141414141414215161629262626
tilesheet swamp
song gloom_for_company
neighbore 17
neighborn 14
neighborw 37
neighbors 88
