1d3b3b3b3b3b3c0000003a3b3b3b3b3b3b3b3b1e
2c0000010102000000010001010000040200022a
2c0100000000000000000000000000000000002a
2c0100000000000000000000000000000000012a
2c0201010000000000000000000000000000022a
2c0139383902000000000000000000000000002a
2c0238013903000000000000000000000000012a
2c0039393803000000000000000000000000012a
2c0138003801000000000000000000000000002a
2c0239393900000000000000000000000000032a
2c0302000000010000000103000200000000012a
2d1b1b1b1b1b1c0100001a1b1b1b1b1b1b1b1b2e
tilesheet midlands
neighborn 17
neighbors 19
