1d3b3b3b3b3b3c0000023a3b3b3b3b3b3b3b3b1e
2c0000000100020000000201010000000100002a
2c0000000000000000000000000000000000012a
2c0000000000000000000000000000000000012a
2c0403000101000000000000000000000000002a
2c0139393900000000000000000000000000042a
2c0138003901000000000000000000000000002a
2c0139393901000000000000000000000000012a
2c0102003800000000000000000000000000012a
2c0000013902000000000000000000000000012a
2c0001010000030001000101020103000100002a
2d1b1b1b1b1b1b1b1b1b1b1b1b1b1b1b1b1b1b2e
tilesheet midlands
neighborn 18
