3b3b3b3b3b3b3b3b3b3b3c78494a48494a48494a
161616161700000000000188595a58595a58595a
2626262627010203040100000000000000650200
363619262700c201010000010104040200030000
0001252627010000010000004300000003020004
0101060606030000530100000301000003030002
1b1c252627040004000001010100010100010202
2b2c252628161616071616161616161616161616
2b2c252626262626072626262626262626262626
2b2c353636363636073636363636363636192626
2b2d1b1b1b1b1c0000011a1b1b1b1b1b1c252626
2b2b2b2b2b2b2c0000002a2b2b2b2b2b2c252626
tilesheet forest
saveto spell:HOME
neighbore 1
neighborw 3
neighborn 21
neighbors 13
sprite 3 5 tolltroll gs:mtn_tolltroll 0 0
song toil_and_trouble
