3b3b3b3b3b3b3b3b3b3b3c78494a48494a48494a
010101040100000203010188595a58595a58595a
0000000000000000000000000000000000650200
0200000000000000010000010104040200030000
1b1c000001000001010000004300000003020004
2b2d1b1c00000000530100000301000003030002
3b3b3b3c00010003000202000100010100010202
1616161616161616161607161616161616161616
2626262626262626262607262626262626262626
3636363636363636363607363636363636192626
1b1b1b1b1b1b1c00020100010001020000252626
2b2b2b2b2b2b2c00000102001a1b1b1b1c252626
tilesheet forest
song toil_and_trouble
neighbore 1
neighborw 3
neighborn 21
neighbors 13
