3b3b3b3b3b3b3c00c6c80178494a48494a48494a
0101010401000000c6c80088595a58595a58595a
0000000000000000d6d800000000000000650200
0101000000000000010000010102000100010203
1c00000000000001010000004304151616161616
2c00010100000000530100000300252626262626
2c03000100030200000000000001353636363636
2c04000200000100000000000000010101000101
2c01020000010100000000000000000000000002
2c00000000030000000000000000000000000100
2c03000001000002020101000002030103010300
2d1b1b1b1b1b1b1b1b1b1b1b1b1b1b1b1b1b1b1b
tilesheet forest
neighbore 1
neighborw 3
neighborn 21
