3b3b3b3b3b3b3b3b3b3b3c78494a48494a48494a
0101010401000002c2000188595a58595a58595a
0000000000000002000000000000000000650200
0200000000000000010000010104040200030000
1b1c000001000001010000004300000003020004
2b2d1b1c00000000530100000301000003030002
3b3b3b3c00010004000001010100010100010202
1616161616161616071616161616161616161616
2626262626262626072626262626262626262626
3636363636363636073636363636363636192626
1b1b1b1b1b1b1c0000011a1b1b1b1b1b1c252626
2b2b2b2b2b2b2c0000002a2b2b2b2b2b2c252626
tilesheet forest
saveto spell:HOME
neighbore 1
neighborw 3
neighborn 21
neighbors 13
song toil_and_trouble
