0101010101010101010101010101010101010101
0101010101010101010101010101010101010101
01010101101112131415161718191a1b01010101
01010101202122232425262728292a2b01010101
01010101303132333435363738393a3b01010101
01010101404142434445464748494a4b01010101
01010101505152535455565758595a5b01010101
01010101606162636465666768696a6b01010101
01010101707172737475767778797a7b01010101
01010101808182838485868788898a8b01010101
0101010101010101010101010101010101010101
0101010101010101010101010101010101010101
tilesheet dots
flags indoors
door 10 9 1 11 3
sprite 6 4 arcade gs:arcade_coinc_3bit gs:arcade_hiscore_8bit 0
song toil_and_trouble
