2121212121212121212121212121212121212121
2121212121212121212121212121212121212121
2121212113313131313131313131313114212121
2121212122070000010403020400010720212121
2121212122050603020201070606000020212121
2121212122070300060402060107020620212121
2121212122010500040501050604050120212121
2121212122050201070406020306070420212121
2121212122030603040307070306040320212121
2121212123111111111134111111111124212121
2121212121212121212121212121212121212121
2121212121212121212121212121212121212121
tilesheet dots
flags indoors
door 10 9 1 11 3
sprite 6 4 treasure item:BROOM 0 0
sprite 8 4 treasure item:WAND 0 0
sprite 10 4 treasure item:FEATHER 0 0
sprite 12 4 treasure item:VIOLIN 0 0
sprite 14 4 treasure item:MATCH 0 0
sprite 6 6 treasure item:UMBRELLA 0 0
song toil_and_trouble
