2700000000000000000000000000000000000000
2700010004000201010200000401020201000000
2700023800390000000000000000010001000200
2700003900390002000101000100000000000000
2700000039010000101201000300040000000000
2703000000020001202201010300000000000000
2701010004000301202200000200010001000200
2702010101020002202201010001000200000000
2700030001000101202201000000010103000200
2700020201000200202200000100000103000000
2702020002040000202201000000000000000100
2816161616161700202200151616161616161616
tilesheet village
neighbors 2
neighbore 11
neighborn 22
