2b1d3b3b3b3b3b3b3b3b3b3b3b3b3b3b3b3b3b1e
2b2c01000400020101020000040102020100002a
2b2c02010000000000000000000001000100022a
2b2c00000000000200010100010000000000002a
1d3c000000010000b6b80100030004000000002a
2c03000000020001c6c80101030000000000002a
2c01010004000301c6c80000020001000100022a
2c02010101020002c6c80101000100020000002a
2c00030001000101c6c80100000001010300022a
2c00020201000200c6c80000010000010300002a
2c02020002040000c6c80100000000000000013a
2d1b1b1b1b1b1c00c6c8006b9798999798999798
tilesheet forest
neighbors 2
neighbore 11
