26262626272a2b2b2c000301030100000000042a
26262626272a2b2b2c000001000001000000002a
26262626273a1e2b2c040000003838010000002a
2626262628172a2b2c000300013900000000002a
2626262626273a1e2d1c0000003838010000002a
262626262628172a2b2c0104003804000000012a
262626262626272a2b2d1c00023904010100002a
361926262626273a1e2b2c00000100010000042a
1c252626262628172a2b2c02000201000100032a
2c351926262626272a2b2c00000101000200012a
2d1c3536192626273a1e2d1c010000000200042a
2b2d1b1c25262628172a2b2c010000020100012a
tilesheet forest
song toil_and_trouble
neighborn 6
neighborw 15
neighbors 25
neighbore 28
