26262626272a2b2b2b1d3c010301003a3b1e2b2b
26262626272a2b2b1d3c000104000201023a1e2b
26262626273a1e2b2c0200000000000000032a2b
2626262628172a2b2c0000000002020000003a1e
2626262626273a1e2d1c0002020002000100002a
262626262628172a2b2c0002000003020000012a
262626262626272a2b2d1c03000001010000002a
361926262626273a1e2b2c00000200010100042a
1c252626262628172a2b2c02000201000100032a
2c351926262626272a2b2c00000101000200012a
2d1c3536192626273a1e2d1c000200000002002a
2b2d1b1c25262628172a2b2d1c0100011a1b1b2e
tilesheet forest
neighborn 6
neighborw 15
neighbors 25
neighbore 28
song toil_and_trouble
