2626262627010100000200020301003a3b1e2b2b
26262626270000040302000000000201023a1e2b
26262626270101020300013e0000000000032a2b
2626262628170000020100010102020000003a1e
262626262627030300000102020002000001002a
262626262628170000000400000003003d01012a
26262626262627a0a1a20000000002000103002a
26261836363637b0b1b20101013e01010100042a
363637020001010000010000000400000100032a
03010000021a1b1b1c000004000101000200012a
1b1b1b1b1b2e2b2b2d1b1b1c000200000002002a
2b2b2b2b2b2b2b2b2b2b2b2d1c0100011a1b1b2e
tilesheet forest
neighborn 6
neighborw 15
neighbors 25
neighbore 28
sprite 11 4 raccoon 0 0 0
sprite 7 8 bonfire 0 0 0
song toil_and_trouble
buried_treasure 13 5 gs:forest_coins1 item:COIN
