2b2b2b2c25262626272a2b2c000000000000002a
2b2b2b2c35363636372a2b2c000000010000022a
3b1e2b2c00010101002a2b2c000000000000012a
003a1e2c00010001002a2b2d1c0000040000002a
00002a2d1c0101011a2e2b2b2c0002010003002a
00003a1e2d1b1b1b2e2b2b1d3c00010300001a2e
0001003a1e2b2b2b1d3b3b3c0100020001002a2b
000400003a3b3b3b3c01000000000300001a2e2b
00030100020100030001000000000000022a2b2b
1b1b1c000100020000020000000000011a2e2b2b
2b2b2d1b1b1b1c020001020101001a1b2e2b2b2b
2b2b2b2b2b2b2d1b1c000001001a2e2b2b2b2b2b
tilesheet forest
song toil_and_trouble
neighborn 24
neighborw 16
neighbors 19
neighbore 35
buried_door 6 3 gs:violin_cave 101 9 7
