6262626262630000000000000061626262626262
0000000000000000000000000000000000000000
0000000000000000000000000000000000000000
0000000000006465000000000000000000000000
0000000000006500640000000000000000000000
0000000000006465000000000000000000000000
0000000000000000000000000000000000000000
0000000000000000000000000000000000000000
0000000000000000000000000000000000000000
0000000000000000000000000000000000000000
0000000000000000000000000000000000000000
1b1b1c0000000000000000000000000000000000
tilesheet desert
neighborw 10
neighbors 8
neighbore 27
neighborn 56
