6262626262630000000000000061626262455252
4747474747480000000000000000000000515252
5757575757594800000000000000000000614552
5757575757575948000000004647480000005152
5757575757575759474747475a57594800006145
5757575757575757575757575749676800000051
6767674a575757574967676767684b4d00000061
424243666767676768000000004b5f5e4d000000
525253000000000000000000006b4f5c5e4c4c4c
52525300000000000000000000006b6c6c4f5c5c
52525443000000000000000000000000006b6c4f
525252544300000000004143000000000000005b
tilesheet desert
saveto spell:TELE5
neighborw 10
neighbors 8
neighbore 27
neighborn 56
song blood_for_silver
