5252525252524462626245525252525252525252
5252525244626300000061626262455252525252
5252524463000000000000000000616262455252
525252530000000000006f006e00000000616262
52525253000000006e00000000006f000000004b
525252530000000000000000000000000000005b
6262626300000000640000000000640000004b5f
0000004b4d000000000000000000000000005b5c
4c4d005b5d000000006400000064000000005b5c
5c5d005b5d0000000000000000000000004b5f5c
5c5d005b5d000000000000000000004b4c5f5c5c
5c5d005b5e4c4c4c4c4c4d004b4c4c5f5c5c5c5c
tilesheet desert
neighborw 26
neighbors 9
neighborn 57
sprite 11 5 treasure item:VIOLIN 0 0
sprite 12 4 bonfire 0 0 0
sprite 11 4 bonfire 0 0 0
sprite 12 5 bonfire 0 0 0
sprite 12 6 bonfire 0 0 0
sprite 11 6 bonfire 0 0 0
sprite 10 6 bonfire 0 0 0
sprite 10 5 bonfire 0 0 0
sprite 10 4 bonfire 0 0 0
song blood_for_silver
