6262626262626262626262626262626262626245
0000000000000000000000000000000000000051
0000000000000000000000000065650000000051
0000000000000000000000000064006500000051
0000000000000000000000000065640000000051
0000000000000000000000000000000000000051
0000000000000000000000000000000000000051
0000000000000000000000000000000000000051
0000000000000000000000000000000000000051
0000000000000000000000000000000000000051
0000000000000000000000000000000000000051
0000000000000000000000000000000000000051
tilesheet desert
song blood_for_silver
neighborw 26
neighbors 9
neighborn 57
neighbore 77
