2b2b1d3c0000000000006b6c6c6c6c6c6c6c6c6c
2b1d3c0000000000000000000000000000000000
2b2c000000000000000000000000000000000000
1d3c000000000000000000000000000000000000
2c00000000000000000000000000000000000000
3c00000000000000000000000000000000000000
4c4d000000000000000000000000000000000000
5c5e4d0000000000000000000000000000000000
5c5c5e4d00000000000000000000000000000000
5c5c5c5e4d000000000000000000000000000000
5c5c5c5c5e4c4c4c4d0000000000000000000000
5c5c5c5c5c5c5c5c5e4c4c4c4c4c4c4c4c4c4c4c
tilesheet desert
song blood_for_silver
neighborn 7
neighborw 24
neighbore 29
neighbors 35
