1d3b3b3c000000000000000000000000003a3b3b
2c00000000000000000000000000000000000000
2c00000000000000000000000000000000000000
2c00000000000000000000000000000000000000
2c00000000000000000000000000000000000000
2c00000000000000000000000000000000000000
2c00000000000000000000000000000000000000
2c00006e6f000000000000000000000000000000
2c00006e006e0000000000000000000000000000
2c00006f6f000000000000000000000000000000
3c00000000000000000000000000000000000000
4c4c4c4c4c4c4c4c4c4c4c4c4c4c4c4c4c4c4c4c
tilesheet desert
song blood_for_silver
neighborn 7
neighborw 24
neighbore 29
neighbors 35
