3b3b3b3b3b3c0000000000000000000000000000
0000000000000000000000000000000000000000
0000000000000000000000000000000000000000
0000000000000000000000000000000000000000
0000000000000000000000000000000000000000
0000000000000000000000000000000000000000
00000000000000006f6f00000000000000000000
00000000000000006f006e000000000000000000
00000000000000006e6e00000000000000000000
0000000000000000000000000000000000000000
0000000000000000000000000000000000000000
4c4c4c4c4c4c4c4c4c4c4c4c4c4c4c4c4c4c4c4c
tilesheet desert
neighborw 28
neighborn 8
neighbore 30
neighbors 36
