6c6c6d000000000000000000000000000000005b
000000000000000000000000000000000000006b
0000000000000000000000000000000000464747
0000000000000000000000000000000000565757
0000000000000000000000000000000000666767
0000000000000000000000000000000000000000
0000000000000000000000000000000000004647
0000000000000000000000000000000000465a57
00000000000000000000000000000000465a5757
000000000000000000000000000000465a575757
0000000000000000000000000000006667676767
4c4c4c4c4c4c4c4c4c4c4c4c4c4c4c4c4c4c4c4c
tilesheet desert
song blood_for_silver
neighborw 28
neighborn 8
neighbore 30
neighbors 36
