6c6c6d00000000006b6c6c6c6d0000000000005b
000000000000000000000000000000000000006b
0000004143004142424300000000000000464747
42430051530051525253464747474747475a5757
5253005153006145525366676767676767676767
5254425553000051525300000000000000000000
5244624554424255446300000000000000004647
626300515252525253000000004b4d0000465a57
000000616262624553000000005b5d00465a5757
4d00000000000061630000004b5f5d465a575757
5d0000004b4d00000000004b5f5c5d6667676767
5e4c4c4c5f5e4c4c4c4c4c5f5c5c5e4c4c4c4c4c
tilesheet desert
neighborw 28
neighborn 8
neighbore 30
neighbors 36
song blood_for_silver
