000000000001010002252627020000000300003a
0000010000030002012526270002000002030100
0000000000000000002526270200000000000000
0403000000000000012526270000000001010003
00020000000000000025262701000000011a1b1b
010101030100020000252627000000001a2e2b2b
003901000039000000252628170001013a3b3b3b
0039380338390100013519262816161616161616
0139003800390100010235192626262626262626
0139000101380000000001353636363636363636
00020102000000000000030001011a1b1b1b1b1b
1b1b1b1b1b1b1b1b1b1b1b1b1b1b2e2b2b2b2b2b
tilesheet mountains
song tangled_vine
neighbore 2
neighborw 4
neighbors 39
neighborn 46
sprite 4 4 treasure item:SHOVEL 0 0
sprite 7 4 treasure item:CHALK 0 0
