00000000000101000001030000005626273a3b3b
0000010200000002000100000002562627484846
0000000003000100040004030000060606474a46
040300000000040001010102010256262749464a
00020001010003020001018081825626271a1b1b
00010002010104000000009091925626272a2b2b
0103000401000102010000a0a1a25626273a3b3b
0000000100010000000100010100661928161616
0000023402010033000001010000006619262626
0002010100000102030000000101010366573636
0100010003010100000003101111111111431a1b
1111111111111111111111242121212121532a2b
tilesheet mountains
hero 12 6 spell:TELE3
neighbore 2
neighborw 4
neighbors 39
neighborn 46
sprite 4 9 treasure item:BELL 0 0
sprite 6 9 treasure item:CHALK 0 0
song nearer_the_sky
