000000000001010002252627020000000300003a
0000010000030002012526270002000002030100
0000000000000000002526270200000000000000
040300000000000001252627a0a1a20001010003
000200000000000000252627b0b1b200011a1b1b
000100020001010000252627939495001a2e2b2b
010300040100000000252628170001013a3b3b3b
0000030002010300013519262816161616161616
0000000001010000010235192626262626262626
0002020000000100000001353636363636363636
00000202010201000000030001011a1b1b1b1b1b
1b1b1b1b1b1b1b1b1b1b1b1b1b1b2e2b2b2b2b2b
tilesheet mountains
hero 13 5 spell:TELE3
neighbore 2
neighborw 4
neighbors 39
neighborn 46
sprite 4 4 treasure item:BELL 0 0
sprite 7 4 treasure item:CHALK 0 0
song nearer_the_sky
