3b3b3b3b3b3b3b3b3b3b3b3b3b3b3b3b3b3b3b3b
0003000002020001000001000401020100000102
0000000000000000000000000000000000000000
0000000000000000000000000000000000000000
1c0000000000000000000000000000000000001a
2c0402010100000000000000000000000000002a
2c0000393900000000000000000000000000002a
2c0100003801000000000000000000000000022a
2c0000003839010000000000000000000000012a
2c0400030400000000000000000000000000022a
2c0001020002000000000200000000020001032a
2d1b1b1b1b1b1b1b1b1b1b1b1b1b1b1b1b1b1b2e
tilesheet midlands
neighbore 2
neighborw 4
