0000000000000000000000000000000000000051
0000000000000000000000000000000000000051
0000000000000000000000000000000000000051
0000000000000000000000000000000000000051
0000000000000000000000000000000000000051
0000000000000000000000000000000000000051
0000000000000000656400000000000000000051
0000000000000000640065000000000000000051
0000000000000000656500000000000000000051
0000000000000000000000000000000000000051
0000000000000000000000000000000000000061
4c4c4c4c4c4c4c4c4d0000004b4c4c4c4c4c4c4c
tilesheet desert
song blood_for_silver
neighborw 29
neighborn 9
neighbors 34
neighbore 79
