2c02000000000000000000000000000000000000
3c00000000000000000000000000000000000000
0100000000000000000000000000000000000000
0000000000000000000000000000000000000000
0000000000000001000300000000000000000000
0001030000000001030100010000000000000000
1617000003000002020201030000000000000000
2628161701000002030101030000000000000000
2626262700000100010001000000000000000000
2626262816170100000301000000000000000000
2626262626281616170003020300030103030203
2626262626262626281616161616161616161616
tilesheet beach
song eye_of_newt
neighborw 19
neighbore 32
neighborn 35
neighbors 85
