1d3c35361926262626262618370100000000023a
3c01010035361926262626270200000000000002
0100000103013519262626270200000000000000
0000000000030035192618370200000003000000
0000000000000003251837000200003e02000000
0001030000000000252700010000010203000000
1617000003000000060603030000000000000000
2628161701030201252701030000000000000000
2626262816161616292817020003000000000000
2626262626262626262628161617000303010302
2626262626262626262626262628161616161616
2626262626262626262626262626262626262626
tilesheet beach
neighborw 19
neighbore 32
neighborn 35
neighbors 85
sprite 6 4 lobster 0 0 0
sprite 13 7 lobster 0 0 0
sprite 12 4 lobster 0 0 0
sprite 9 2 seamonster 0 0 0
song eye_of_newt
