2c02000000000000000000000000000000000000
3c00000000000000000000000000000000000000
0100000000000000000000000000000000000000
0000000000000000000000000000000000000000
0000000000000001030001000000000000000000
0000000000000003383802030000000000000000
0000000000000002380239020000000000000000
0000000000000000383900010000000000000000
0000000000000001390039030000000000000000
0000000000000003393801030000000000000000
0303020303030200030201000300030103030203
1616161616161616161616161616161616161616
tilesheet beach
song eye_of_newt
neighborw 19
neighbore 32
neighborn 35
neighbors 85
