0000000000000000000000000000000000000000
0000000000000000000000000000000000000000
0000000000000000000000000000000000000000
0000000000000103030300000000000000000000
0000000000000338380301000000000000000000
0000000000000339033901000000000000000000
0000000000000038380100000000000000000000
0000000000000239003800000000000000000000
0000000000000338380002000000000000000000
0000000000000303000300000000000000000000
0203030201020003000202030102030302010100
1616161616161616161616161616161616161616
tilesheet beach
song eye_of_newt
neighborw 31
neighbore 33
neighborn 36
neighbors 84
