0000000000000000000000000000000000000225
0000000000000000000000000000000000000125
0000000000000000000000000000000000010025
0000000003010203000000000000000000031529
0000000001383802030000000000000003012526
0000000002390339000000000000000000152926
0000000001383801030000000000000103252626
0000000002380238010000000200031516292626
0000000000383803030000000315162926262626
0000000001030303030103011529262626262626
0200030100000003011516162926262626262626
1616161616161616162926262626262626262626
tilesheet beach
neighborw 32
neighborn 34
neighbore 81
neighbors 83
song eye_of_newt
