3b3b3b3b3b3b3b3b3c0201013a3b3b3b3b3b3b3b
0300000201010200000303020300020003020115
0000000000000000000000000000000000000325
0000000000000000000000000000000000000225
0000000000000000000000020002000000000225
0000000000000000000002383903000000000125
0000000000000000000003380339030000000125
0000000000000000000002383900030000000025
0000000000000000000002380038000000000325
0000000000000000000001383901020000000225
0000000000000000000002020003000000000325
0000000000000000000000000000000000000225
tilesheet beach
song eye_of_newt
neighbors 33
neighborw 36
neighborn 30
neighbore 80
saveto spell:TELE1
