1d3b3b3b3b3b3b3b3b3b3b3b3b3b3b3b3b3b3b3b
2c03010100010303010001030202030202020202
2c023e3d01000000000000000000000000000000
2c033d013d030000000000000000000000000000
2c033e3d03000000000000000000000000000000
2c033d013e000000000000000000000000000000
2c013d3d02020000000000000000000000000000
2c00020302000000000000000000000000000000
2c00000000000000000000000000000000000000
2c02000000000000000000000000000000000000
2c02000000000000000000000000000000000000
2c02000000000000000000000000000000000000
tilesheet beach
neighbors 31
neighborw 25
neighborn 28
neighbore 36
song eye_of_newt
