3b3b3b3b3b3b3b3b3b3b3b3b3b3b3b3b3b3b3b3b
0000010002000202010302010002020300000200
0000000003000102000000000000000000000000
00000000013d3e02010000000000000000000000
00000000023e013e010000000000000000000000
00000000033d3d02000000000000000000000000
00000000033d033e020000000000000000000000
00000000033d3e00000000000000000000000000
0000000001020200000000000000000000000000
0000000000000000000000000000000000000000
0000000000000000000000000000000000000000
0000000000000000000000000000000000000000
tilesheet beach
neighborw 35
neighborn 29
neighbors 32
neighbore 34
song eye_of_newt
