0000000000000000000000000000000000000030
0000000000000000000000000000000000000000
0000000000006364000000000000000000000000
0000000000006400000000000000000000000000
0000000000646400000000000000000000000000
0000000000000000000000000000000000000000
0000000000000000000000004041414200000000
0000000000000000000000405451515342000000
4142000000000000000040545151515152000000
5153420000000000404154515151515153420000
5151534142000000505151515151515151534200
5151515153414141545151515151515151515341
tilesheet swamp
song gloom_for_company
neighbore 18
neighborn 38
neighborw 42
neighbors 89
