8b00899b0200998b038c0103898b03998b030330
8b028c00027c008c008c00799a8b03038c02797a
9b039c02799b039c009c008c0099ab039c03999a
000201039c0202000203009c0002030101030203
0001000000020387880202000200000002000100
03010300010000979879ab000003000300000000
0001030100000001a99b01004041414141414141
0000000000630000000001405443614451515151
0100000301000040420040545152005043614451
0003404141414154534154515153415452005051
4141545151515151515151515151515153415451
5151515151515151515151515151515151515151
tilesheet swamp
neighbore 18
neighborn 38
neighborw 42
neighbors 89
door 1 2 39 -1 -1
door 3 2 39 -1 -1
door 8 2 39 -1 -1
door 10 2 39 -1 -1
door 15 2 39 -1 -1
door 17 2 39 -1 -1
song gloom_for_company
callback ev:LOADED cb:swamp_maze gs:swamp_maze_3bit
