0001000000010000020000000002000003000330
0300020003010202000200000000000200000003
0200000002000000000003010000000000000103
0000000000000000000000020001000003010003
0001000002010387880300020000000002000100
0301030001000097980000000003000200000003
0001030100000000000000004041414200000001
0000000000000002000000405451515342030000
4142000000000000000040545151515152000203
5153420000030300404154515151515153420202
5151534142000000505151515151515151534200
5151515153414141545151515151515151515341
tilesheet swamp
song gloom_for_company
neighbore 18
neighborn 38
neighborw 42
neighbors 89
