0000000000000002000203000202000101000020
0003000100030000010000000000030003000020
0100010203000000010300000000000003030020
0101000000000100000000010003000300000020
0200010000018081838182818283818281828420
0003000200009093939192919292929291929420
0000000000000000000300000000000000030020
0001000200020002000000010000000000000020
0002010003020000028081838384000000000120
0000000000000002009092929194000000000320
0000030000020001010000000001000000000020
0000030000000302000001000002000003020020
tilesheet swamp
neighbors 37
neighbore 14
neighborn 39
neighborw 41
song gloom_for_company
