b3b2b3b2b3b2b3b2b3b2b3b2b3b2b3b2b3b4b55d
0200000000020000030001000000000302004d4c
0003010200010001030000020000000101025d5e
00010100000000000000494a4b00000100035d5e
a2a3a2a3a2a3a2a3a4a5595a5b00000100005d5e
b2b3b2b3b2b3b2b3b4b5696a6b00000000006d5c
7b0000000003008586010000030001000102005f
8b030000000001959600000000000101004d4e4f
8b010101020200010100030200007c01006d6f5e
8b000379ab010002a97b02020300997b02006d6f
8b03008c03000200018c03037c00038c0300035d
8b00798b02017c03028c03018c01038c0000005d
tilesheet swamp
hero 11 5 spell:TELE2
neighbors 38
neighbore 13
neighborn 3
neighborw 40
song gloom_for_company
callback ev:LOADED cb:swamp_maze gs:swamp_maze_3bit
