3131313131313131313131313131313131313114
0000000000000000000000000000000000000020
0000000000000000000000000000000000000020
0000000000000000000000000000000000000030
0000000000000000636300000000000000000000
0000000000000000640000000000000000000000
0000000000000064630000000000000000000000
0000000000000000000000000000000000000010
0000000000000000000000000000000000000020
0000000000000000000000000000000000000020
0000000000000000000000000000000000000020
0000000000000000000000000000000000000020
tilesheet swamp
song gloom_for_company
neighbors 38
neighbore 13
neighborn 3
neighborw 40
