b3b2b3b2b3b2b3b2b3b2b3b2b3b2b3b2b3b4b514
0200000000020000030001000000000302000020
0003010200010001030000020000000101000020
00010100000000000000494a4b00000100000020
a2a3a2a3a2a3a2a3a4a5595a5b00000100020020
b2b3b2b3b2b3b2b3b4b5696a6b00000000020130
7b00000000030085860100000300010002030001
8b03000000000195960000000000010100101111
8b010101020200010100030200007c0100301421
8b000379ab010002a97b02020300997b02033014
8b03008c03000200018c03037c00038c03000320
8b00798b02017c03028c03018c01038c00000020
tilesheet swamp
hero 11 5 spell:TELE2
neighbors 38
neighbore 13
neighborn 3
neighborw 40
song gloom_for_company
callback ev:LOADED cb:swamp_maze gs:swamp_maze_3bit
