b3b2b3b2b3b2b3b2b3b2b3b2b3b2b3b2b3b4b514
0200000000020000030001000000000302000020
0003010200010001030000020000000101000020
00010100000000000000494a4b00000100000030
a2a3a2a3a2a3a2a3a4a5595a5b00000100020100
b2b3b2b3b2b3b2b3b4b5696a6b00000000020300
0001000000030085860100000300010000000200
0000000000000195960000000002000000000010
0002000000010000020001020000000000000020
0000000000000002000000010002030000000020
0000020202020003000001030000000300020020
0000000000000000000000010100000000000020
tilesheet swamp
hero 11 5 spell:TELE2
neighbors 38
neighbore 13
neighborn 3
neighborw 40
sprite 6 2 treasure item:WAND 0 0
sprite 4 2 treasure item:UMBRELLA 0 0
song gloom_for_company
