5c5c5c5c5c5c5c5c5c5c5c5c5c5c5c5d00000000
5c5c5c5c5c5c5c5c5c5c5c5c5c5c5c5e4d000004
6c6c4f5c5c5c5c5c5c5c5c5c5c5c5c5c5e4d0002
01016b6c4f5c5c5c5c5c5c4e6c8c6c4f5c5d0203
000400006b6c6c4f5c5c4e6d0002006b6c6d0000
000001030000005b5c4e6d030001000003000001
000000000301006b6c6d00000000000004000000
0202000001020010111201000100000400000002
0200020003101124212311111112000100000300
0000101111242121212121212123111112010000
1111242121212121212121212121212123120000
2121212121212121212121212121212121231111
tilesheet mountains
neighbore 3
neighborw 5
neighbors 40
neighborn 49
song nearer_the_sky
