0100030100000100000000010001000000040000
0001040001000200010001010201010000030204
0000000000000100040201030101000002010002
0400010000010100000000000001000000000103
0002020001000300010000000003000000000300
0000010302010200000100000401000203000301
0000000003010000000200030000000004000000
0202000000010101010000010004000400000002
0200030101020002000000010101000003000300
0303000004010100000002000103010101000000
0101030101040004040302000000010003000102
1b1b1b1b1b1b1b1b1b1b1b1b1b1b1b1b1b1b1b1b
tilesheet mountains
neighbore 3
neighborw 5
neighbors 40
neighborn 49
sprite 3 8 hattroll 0 0 0
sprite 4 4 hattroll 0 0 0
sprite 9 3 hattroll 0 0 0
sprite 11 7 hattroll 0 0 0
song tangled_vine
