0100030100000100000000010001000000040000
0001040001000200010001010201010000030204
0000000000000000000000000000000002010002
0400010000000000000000000000000000000103
0002020000000000000000000000000000000300
0000010302010000010004000000000000000301
0000000003000039000200380000000000000000
0202000000010339380239380100000000000002
0200030101030038013901390000000000000300
0303000004010038000100390000000000000000
0101030101040300000000010000000000000102
1b1b1b1b1b1b1b1b1b1b1b1b1b1b1b1b1b1b1b1b
tilesheet mountains
neighbore 3
neighborw 5
neighbors 40
neighborn 49
