3b3b3b3b3b3b3b3b3b3b3b3b3b3b3b3b3b3b3b3b
0102000100010101010000010000010001000201
0000000000000000000000000000000000000000
0000000000000000000000000000000000000000
1c0000000000000000000000000000000000011a
2c0100030003000000000000000000000000002a
2c0002393900000000000000000000000000012a
2c0002023900020000000000000000000000002a
2c0200393939000000000000000000000000012a
2c0301020101000000000000000000000000002a
2c0003010104000000000000020000000000002a
2d1b1b1b1b1b1b1b1b1b1b1b1b1b1b1b1b1b1b2e
tilesheet midlands
neighbore 3
neighborw 5
