5c5c5c5c5c5c5c5c5c5c5c5c5c5c5c5d0200005b
5c5c5c5c5c5c5c4e6c6c6c6c6c6c6c6d0101015b
5c4e6c8c6c4f4e6d040101050000000101004b5f
5c5d0403026b6d020203020005000205004b5f5c
5c5d0001050000054b4c4c4c4c4c4c4c4c5f5c5c
5c5e4c4c4c4c4c4c5f5c4e6c6c6c6c6c6c6c6c6c
5c5c5c5c4e6c6c6c6c6c6d020101010300010102
6c6c6c6c6d030001000401050000010000101111
0000000000010000000000010010111111242121
0001010002000010111111111124212121212121
1111111111111124212121212121212121212121
2121212121212121212121212121212121212121
tilesheet mountains
saveto spell:TELE3
neighbore 3
neighborw 5
neighbors 40
neighborn 49
door 3 2 139 3 2
sprite 10 3 skyleton 0 0 0
song nearer_the_sky
