3131313131313131313131313131313131313131
0000000000000000000000000000000000000000
0000000000000000000000000000000000000000
0000000000000000000000000000000000000000
0000000000000000000000000000000000000000
0000000000000000000000000000000000000000
0000000000000000000000000000646400000000
0000000000000000000000000000630000000000
0000000000000000000000000064640000000000
0000000000000000000000000000000000000000
0000000000000000000000000000000000000000
0000000000000000000000000000000000000000
tilesheet swamp
neighbore 39
neighborn 4
neighbors 41
neighborw 43
