3131313132b0b1b2b3b2b3b2b3b2b3b2b3b2b3b2
0100000000030000000002000001000001000000
0302000302010100020101030202000002000000
0001010000020000000000000103000000020000
00000002000201030300a0a1a2a3a2a3a2a3a2a3
00030001004748000200b0b1b2b3b2b3b2b3b2b3
0000000100575800030003000000020300000200
0101000001000003000001000200000001000003
0300000100000003000100006566000103000000
0000020000000000000300007576020200000000
0000000000000000000000000300000000010000
0000000300000001030000030100000200000000
tilesheet swamp
neighbore 39
neighborn 4
neighbors 41
neighborw 43
song gloom_for_company
