0301000000000300000000000001000303000000
0000010000000000010003000100000002000002
0001010001000000000000030000000000000203
0000000000020000000000030000000000000000
0002008788030203000002016566000100000000
0300009798030000676800017576020000000002
0100020000000000777800000100010301000000
0001000300020300000000000000000201000000
0000000001000000000000000000000001030000
0000000001020002010102010300020000010100
0100000100000000000000000000000000000002
0002000000000001000100000000000000000300
tilesheet swamp
song gloom_for_company
neighborn 40
neighbore 38
neighbors 42
neighborw 44
