0301000000000300000000000001000303000389
0000010000000000010003000100000002000189
0001010001000000000000030000000000000089
0000000000020000000000030000000000000089
0002008788030203000002016566000100000389
0300009798030000676800017576020000000089
0100020000000000777800000100010301000189
0001000300020300000000000000000201000389
0000000001000000000000000000000001030089
0000000001020002010102010300020000010389
0100000100000000000000000000000000000289
0002000000000001000100000000000000000189
tilesheet swamp
neighborn 40
neighbore 38
neighbors 42
neighborw 44
song gloom_for_company
