0000000000000000000000000000000000000000
0000000000000000006464000000000000000000
0000000000000000006300000000000000000000
0000000000000000636400000000000000000000
0000000000000000000000000000000000000000
0000000000000000000000000000000000000000
4141420000000000000000004042000000000000
5151534200000000000000405453414142000000
5151515200000000000040545151515153414141
5151515342000000000050515151515151515151
5151515153414141414154515151515151515151
5151515151515151515151515151515151515151
tilesheet swamp
neighborn 41
neighbore 37
neighborw 45
neighbors 90
