6161616200010060616161620300000000998a8a
000002020000000000000000030300000101998a
0000030000020000000000000000010000000399
0000000064000000010000020001000002030001
0002020103004041414200020300630200000000
0001000200006044436200000001020000000000
4141420000030260620002034042000000000000
5151534200000001000300405453414142000000
5151515200000000000040545143614453420000
5151515342000000000050515152005051520200
5151515153414141414154515153415451534141
5151515151515151515151515151515151515151
tilesheet swamp
neighborn 41
neighbore 37
neighborw 45
neighbors 90
song gloom_for_company
