6161616144514361616161620100000000998a8a
000002026044526c6c6c6c6c656600000101998a
000003000060626c6c6c6c6c7576000000000399
000000010000006c6c6c6c6c0002000002030001
000000404141426c6c6c6c6c4041420100000000
000140545151526c6c6c6c6c5051520001000000
4141545151515341414141415451534201000000
5151515151436161616144515151515342000000
5151515143620000010150515143614453420000
5151515152010000000050515152005051520200
5151515153414141414154515153415451534141
5151515151515151515151515151515151515151
tilesheet swamp
neighborn 41
neighbore 37
neighborw 45
neighbors 90
sprite 7 1 trickfloor 0 0 0
song gloom_for_company
