0000000000010000000000000300000000000000
0000020300000000030001000003000001000000
0000030000000000000000000000010000000300
0000000203000000000100020000000002030100
0002020300000301000200020300000000000000
0001000200000101020000000000000000000000
4141420000000201010003034042000000000000
5151534200000000000300405453414142000000
5151515200000000000040545151515153414141
5151515342000000000050515151515151515151
5151515153414141414154515151515151515151
5151515151515151515151515151515151515151
tilesheet swamp
neighborn 41
neighbore 37
neighborw 45
neighbors 90
song gloom_for_company
