3131313131313131320000003031313131313131
4141414141414203000002000300000000000300
5151515151436200020000000101000103000003
5151515143620101000045460000000200010001
5151514362020000000055560000000200030002
5151436201000000020000000003010000000000
5151520203008082818282828282838400010001
5143620000009093939191929393929400020000
5152000200000200000000000000010200000102
5152000101010001010002000000010003000000
5153420300000200000000000002000300000002
5151520003000000000000030001000000020002
tilesheet swamp
saveto spell:TELE2
neighbore 40
neighborn 5
neighbors 44
neighborw 95
song gloom_for_company
