3131313131313131320000003031313131313131
4141414141414200000000000000000000000000
5151515151436200000000000000000000000000
5151515143620000000000000000000000000000
5151514362000000000000000000000000000000
5151436200000000000000006364000000000000
5151520000000000000000006400000000000000
5143620000000000000000636300000000000000
5152000000000000000000000000000000000000
5152000000000000000000000000000000000000
5153420000000000000000000000000000000000
5151520000000000000000000000000000000000
tilesheet swamp
neighbore 40
neighborn 5
neighbors 44
neighborw 95
