5151520003010000000000020260620000030201
5151534200000300030100026566000000000002
5151515202000000000001017576000100000000
5151515341420040414141420303000000000040
5151514361620060616144534201000000000050
5151515200010100000060445342030000004054
5151436200020247480300505152000102005051
5143620000000057580100504362030000016044
4362000102630201000000606200020003010050
5201000000000000640300000000010200000350
5200000000000201000000000003000001000050
5200030000000300020000030000010240414154
tilesheet swamp
neighborn 43
neighbore 41
neighbors 45
neighborw 94
sprite 6 5 alphablock_gamma 0 0 0
sprite 10 6 duck 0 0 0
song gloom_for_company
