5151520003010000000000020000000200030201
5151534200000300030100020100000300000002
5151515200010000000200000300000100000001
5151515342000001000000030000000000000001
5151514362000200030003000001000000010000
5151515200000100000002010003000000000000
5151436200020247480003000001000102000000
5143620000000057580100020100020000030000
4362000100030003000000000100000003020001
5201000000000102000003000103010200000000
5200000000000203030000000003000203000000
5200030000000300020000030000010200030000
tilesheet swamp
neighborn 43
neighbore 41
neighbors 45
neighborw 94
song gloom_for_company
