5151520003010000000000010050520200030201
5151534200000300000003004054520100000002
5151515202000000000000005043620100000000
5151515341420040414201405452000300000040
5151514361620060445200606162030000000050
5151515200010301505202010003030000004054
5151436200020200606200404142020102005051
5143620000000001000000504362030000016044
4362000102630047480100606200020003010050
5201000000000057580300000000010200000350
5200000000000201000000000003000001000050
5200030000000300020000030000010240414154
tilesheet swamp
neighborn 43
neighbore 41
neighbors 45
neighborw 94
sprite 6 5 alphablock_gamma 0 0 0
sprite 12 5 duck 0 0 0
sprite 10 2 alphablock_gamma 0 0 0
song gloom_for_company
