5151520000000000000000000000000000000000
5151534200000000000000000000000000000000
5151515200000000000000000000000000000000
5151515342000000000000006464000000000000
5151514362000000000000006400000000000000
5151515200000000000000646300000000000000
5151436200000000000000000000000000000000
5143620000000000000000000000000000000000
4362000000000000000000000000000000000000
5200000000000000000000000000000000000000
5200000000000000000000000000000000000000
5200000000000000000000000000000000000000
tilesheet swamp
song gloom_for_company
neighborn 43
neighbore 41
neighbors 45
neighborw 94
