5200000000000000000000000000000000000000
5200000000000000000000000000000000000000
5200000000000000000000000000000000000000
5342000000636300000000000000000000000000
5152000000630000000000004042000000000000
5152000064630000000000405453420000000000
5152000000000000000040545151534200004041
5152000000000000000050515151515341415451
5152000000000000004054515151515151515151
5153420000000000405451515151515151515151
5151534141414141545151515151515151515151
5151515151515151515151515151515151515151
tilesheet swamp
song gloom_for_company
neighborn 44
neighbore 42
neighbors 91
neighborw 93
