5200000200000300000000000000020360616161
5200010000000000020000000000000000000300
5200030002030200000100000100000000000000
5342000000000100000100030000000100000100
5152030000030003004041414142000202000000
51534200c0c1c200405451515153420002010300
51515200d0d1d200505151515151534200004041
51515200e0e1e200505151515151515341415451
5151520001030000505151515151515151515151
5151534141414141545151515151515151515151
5151515151515151515151515151515151515151
5151515151515151515151515151515151515151
tilesheet swamp
neighborn 44
neighbore 42
neighbors 91
neighborw 93
sprite 4 3 alphablock_gamma 0 0 0
sprite 6 3 alphablock_alpha 0 0 0
sprite 5 4 pushblock 0 0 0
sprite 5 6 static_educator 0 0 0
song gloom_for_company
