5200000200000300000000000000020100000000
5200010000000000020000000000000101000000
5200030002030200000100000100000000000000
5342000000000100000003010000000100000100
5152010003030000000003004042000202000000
5152000300000000000000405453420002010300
5152030100000000000040545151534200004041
5152000100020100000050515151515341415451
5152000000010200004054515151515151515151
5153420000000302405451515151515151515151
5151534141414141545151515151515151515151
5151515151515151515151515151515151515151
tilesheet swamp
song gloom_for_company
neighborn 44
neighbore 42
neighbors 91
neighborw 93
