000000000000000000252627000000000000032a
000000000000000000252627040000000000022a
000000000000000000252627030000000000002a
000000000001020101252627000000000000012a
000000000000010000252627010000000000012a
000000000000010001252627000000000000002a
000000000000020003060606010000000000002a
000000000000010000252627000000000000012a
000000000001000001252627010000000000002a
000000000000000000252627040000000000042a
000000000000000003252627010000000000012a
000000000000000000252627000000000000002a
tilesheet mountains
neighbors 3
neighbore 21
neighborn 47
neighborw 49
