3b3b3b3b3b3b3b3b3b3b3b3b3b3b3b3b3b3b3b1e
000401030103000100151617000001000000002a
000000000000000001252627000000000000002a
000000000000000000252627000000000000022a
000000000000020001252627000002010100012a
000000000000010301252627000004000000012a
000000000000010000252627010002010000002a
000000000000000200252627000000000000012a
000000000000000200252627000000000000002a
000000000000010102252627010000000000012a
000000000000000000252627020000000000012a
000000000000000001252627000000000000022a
tilesheet mountains
neighbors 46
neighbore 22
neighborw 48
song nearer_the_sky
