3b3b3b3b3b3b3b3b3b3b3b1e2b2b1d3b3b3b3b3b
03010000020200000200013a3b3b3c0201000001
0000000000000000000000020001040100000000
0000000000000000000000000000000000000000
0000000000000204030000040100000000000000
000000000000003d0004003e0100000000000000
000000000000003e3e023e3d0100000000000000
000000000000003e003d013d0400000000000000
000000000000013d0101023e0200000000000000
0000000000000100020001000100000000000000
0000000000000000000000000000000000000000
0000000000000000000000000000000000000000
tilesheet mountains
neighbore 47
neighbors 49
neighborw 51
neighborn 63
