01010502020102005b5c5c5c5c5c5c5c5c5c5c5c
02000402000204025b5c5c5c5c5c5c5c5c5c5c5c
0000056e0501034b5f5c5c5c5c5c5c5c5c5c5c5c
0005040502004b5f5c5c5c5c5c5c5c5c5c5c5c5c
4c4d0102054b5f5c5c5c5c5c5c5c5c5c5c4e6c6c
5c5e4c4c4c5f5c4e6c8c6c6c4f5c5c4e6c6d0500
5c5c5c5c5c5c4e6d030204016b6c6c6d01030001
5c5c5c5c5c5c5d00050000010303000201050000
5c5c5c5c5c5c5d0201030200040204046e010204
5c5c5c5c5c5c5e4c4c4c4c4c4d0503020205024b
5c5c5c5c5c5c5c5c5c5c5c5c5e4d02030102045b
5c5c5c5c5c5c5c5c5c5c5c5c5c5e4c4d0501045b
tilesheet mountains
neighborn 48
neighbore 46
neighbors 4
neighborw 50
door 9 5 136 9 5
sprite 4 2 hattroll 0 0 0
sprite 10 7 skyleton 0 0 0
song nearer_the_sky
