5c5c5c5c5c5c5c5c5c5c5c5c5c5c5c5c5c5c5c5c
5c5c5c5c5c5c5c5c5c5c5c5c5c5c5c5c5c5c5c5c
5c5c5c5c5c4e6c6c6c8c6c6c4f5c5c5c5c5c5c5c
5c5c4e6c6c6d0000000001006b4f5c5c5c5c5c5c
6c6c6d050103000100010001016b4f5c5c4e6c6c
00050200020001020402010003015b5c5c5d0500
01000200010000000003000101005b5c4e6d0201
01020200000300010000000100045b5c5d010000
000300000003020000030200014b5f5c5d000202
4c4c4d02010101014b4c4c4c4c5f5c4e6d010200
5c5c5e4c4c4c4c4c5f5c5c5c5c5c5c5d00030001
5c5c5c5c5c5c5c5c5c5c5c5c5c5c5c5d01010101
tilesheet mountains
neighborn 48
neighbore 46
neighbors 4
neighborw 50
song nearer_the_sky
