0000000000000000000000000000000000000000
0000000000000000000000000000000000000000
0000000000000000000000000000000000000000
0000000000000000000200000000000000000000
0000000000003d0101013d010000000000000000
0000000000003e3e003d3d000000000000000000
0000000000043e003e013d030000000000000000
0000000000003d0400013e020000000000000000
0000000000020001000002020000000000000000
0000000000000000000000000000000000000000
0000000000000000000000000000000000000000
0000000000000000000000000000000000000000
tilesheet mountains
song tangled_vine
neighborn 48
neighbore 46
neighbors 4
neighborw 50
