5c5c5c5c4e6d010203010300000100006b4f5c5c
5c5c5c5c5d0000030000000000000101006b4f5c
5c5c5c5c5d010000010203040001020003006b6c
5c5c5c5c5d010000000102020103000000030001
5c5c5c4e6d010000020001000401020001020300
5c5c5c5d00000100000000010002010002040301
6c6c6c6d00000300000134000200010302010000
1111111201000201020200000000040302010102
2121212311120001010100000003000104000300
2121212121231111120000010101101112000502
2121212121212121220000001011242123111111
2121212121212121220000002021212121212121
tilesheet mountains
saveto spell:TELE3
neighbore 4
neighbors 43
neighborn 50
neighborw 96
song nearer_the_sky
