1d3b3b3b3b3b3b3b3b3b3b3b3b3b3b3b3b3b3b3b
2c00000000020101000100000101000001010201
2c00000000000000000000000000000000000000
2c00000000000000000000000000000000000401
2c0200000000000000000000000000000000001a
2c0000010400000000000000000000000000032a
2c0000393939000000000000000000000000002a
2c0000380238000000000000000000000000002a
2c0100383939010000000000000000000000012a
2c0400010201010000000000000000000000002a
2c0201000100010002000301030000000000012a
2d1b1b1b1b1b1b1b1b1b1b1b1b1b1b1b1b1b1b2e
tilesheet midlands
neighbore 4
