2c00000200000002030103000001000001010100
2c00000101010000000200000000010301000302
2c00000000000000000000000000000000000000
2c00000000000000000000000000000000000101
2c02000000000000000000000000000000000000
2c00000000010001020000000000000000000001
2c00003900040039000000000000000000000000
2c00003938023939030000000000000000000202
2c01023800380139000000000000000000000000
2c04003900010039010000000000000000000002
2c02000000000000010203000000000000000100
2d1b1b1b1b1b1b1b1c0300001a1b1b1b1b1b1b1b
tilesheet mountains
saveto spell:TELE3
neighbore 4
neighbors 43
neighborn 50
neighborw 96
song tangled_vine
