2c00000000000000000000000000000000000000
2c02000000000000000000000000000000000000
2c03000000000000000000000000000000000000
2c03000000000000030001020200000000000000
2c0000000000033d0004013d0000000000000000
2c0000000000003e3e003e3e0000000000000000
2c0400000000013d003e013d0000000000000000
2c0000000000003e0001003d0100000000000000
2c03000000000001000000000300000000000000
2c00000000000000000000000000000000000000
2c02000000000000000000000000000000000000
2c03000000000000000000000000000000000000
tilesheet mountains
neighbore 49
neighbors 5
neighborn 51
neighborw 97
