1d3b3b3b3b3b3b3b3b3b3b3b3b3b3b3b3b3b3b3b
2c04010200000001000100010001000200010102
2c00000001000000020000000000000000000000
2c030000033d0001003e01000000000000000000
2c000000043e3e013d3d00000000000000000000
2c020000013e003e023d01000001000000000000
2c000000003d0201023e01000100000000000000
2c02000000010100020200000000000000000000
2c00000000000000000000000000000000000000
2c00000000000000000000000000000000000000
2c00000000000000000000000000000000000000
2c01000000000000000000000000000000000000
tilesheet mountains
neighbors 50
neighbore 48
song tangled_vine
