2121220000000000000000000000000000000000
2113320000000000000000000000000000000000
2122000000000000000000000000000000000000
1332000000000000000000000000000000000000
2200000000000000000000000000000000000000
2200000000000000000000000000000000000000
3200000000000000000000000000000000000000
0000000000000000000000000000000000000000
0000000000000000000000000000000000000000
0000000000000000000000000000000000000000
1111111111111112000000000000000000000000
2121212121212123111111111111111111111111
tilesheet steppe
neighbors 10
neighborw 53
neighborn 55
neighbore 56
song first_frost
