2121220000590000590002590059000020212121
2113320002590300590000590059000120212121
2122000000590000664802667768000130142121
3132004677680000005902010000010001303131
0002006900000002006677774800000000000100
0000101200101111111111126677780000000002
1111242202301413311421220000001516161616
3131313200003032033014220003023536361926
0100000000000001000030320000000000003536
0002000000000100000000010010120000000100
1111111111111111120100000020220002000000
2121212121212121231111111124231111111111
tilesheet steppe
neighbors 10
neighborw 53
neighborn 55
neighbore 56
sprite 7 7 firenozzle_s 2 0 gs:steppe_fire1
sprite 7 3 penguin 0 0 0
sprite 13 6 penguin 0 0 0
song first_frost
