2121220000000000000000000000000000202121
2121220000000000000000000000000000202121
2121220000000000000000000000000000202121
2121220000000000000000000000000010242121
2121220000000000000000000000000020212121
2121231112000000000000000000001024212121
2121212123120000000000000000002021133131
2121212121231112000000000000003031320000
2121212121212123111112000000000000000000
2121212121212121212123111200000000000000
2121212121212121212121212312000000101111
2121212121212121212121212123111111242121
tilesheet steppe
song first_frost
neighbore 52
neighbors 23
neighborw 12
neighborn 54
