2121220059005900015900005900590000202121
2121220059005900005900005900590001202121
2121220059005900466802466800590010242121
2121220359016677580000590002590020133131
2121220059000000690000667777680020220000
2113327668000000390002000300001024220000
2122030003020001101111111111112421231111
1332020100000010242113313131311421133131
2202000000101124212122020002023031320000
2200000010242121212123111201000200000000
2201000120212121212121212312030000101111
2311111124212121212121212123111111242121
tilesheet steppe
neighbore 52
neighbors 23
neighborw 12
neighborn 54
sprite 2 9 treasure item:BROOM 0 0
song first_frost
