3636363636363636363636363636363636363636
0000000000000000000000000000000000000000
0000000000000000000000000000000000000000
0000000000000000000000000000000000000000
0000000000000000000000000000000000000000
0000000000000000000000000000000000000000
0000000000000000000000000000000000000000
0000000000000000000000000000000000000000
0000000000000000000000000000000000000000
1200000000000000000000000000000000000000
2200000000000000000000000000000000000000
2200000000000000000000000000000000000000
tilesheet steppe
neighbors 53
neighbore 55
neighborw 60
neighborn 70
