2225262626262626262618363636363636363636
2225262626262618363637000000000000000000
2225262626183637000000000000000000000000
2235192618370000000000000000000000000000
2312251837000000000000000000000000000000
2122252700000000000000000000000000000000
2122252700000000000000000000000000000000
2122353700000000000000000000000000001011
2123120000000000000000000000000000102421
2121220000000000000000000000000000202121
2121220000000000000000000000000000202121
2121220000000000000000000000000000202121
tilesheet steppe
song first_frost
neighbors 53
neighbore 55
neighborw 60
neighborn 70
