2121212122252626262701353636363636363636
1340414232252618363700000000790000000000
2250515216292627000000000076777777777777
2235192626261837000000000000000000010001
2312251836363700000076477777777777777777
2122252700000100000100590100000100010003
2122252700000000000101590000020001000200
2122353700000000000000664800467748000000
2123111111111112000000015901590059000200
3131313131311422004678005900590066777777
0002000003003032005900005900590000010000
1111120049004900005900005900590000101111
tilesheet steppe
saveto spell:TELE6
neighbors 53
neighbore 55
neighborw 60
neighborn 70
door 2 1 141 15 9
sprite 7 5 penguin 0 0 0
song first_frost
