2121212122252626262618363636363636363636
1340414232252618363637000000000000000000
2250515216292627000000000000000000000000
2235192626261837000000000000000000000000
2312251836363700000000000000000000000000
2122252700000000000000000000000000000000
2122252700000000000000000000000000000000
2122353700000000000000000000000000001011
2123120000000000000000000000000000102421
2121220000000000000000000000000000202121
2121220000000000000000000000000000202121
2121220000000000000000000000000000202121
tilesheet steppe
saveto spell:TELE6
neighbors 53
neighbore 55
neighborw 60
neighborn 70
door 2 1 141 15 9
song first_frost
