3636363636363636363636363636363636363636
0000000000000000000000000000000000000000
0000000000000000000000000000000000000000
0000000000000000000000000000000000000000
0000000000000000000000000000000000000000
0000000000000000000000000000000000000000
0000000000000000000000000000000000000000
1112000000000000000000000000000000000000
2123120000000000000000000000000000000000
2121220000000000000000000000000000000000
2121220000000000000000000000000000000000
2121220000000000000000000000000000000000
tilesheet steppe
neighborw 54
neighbors 52
neighbore 59
neighborn 71
song first_frost
