36363700590225262618363636363700354b0025
0000000359002518363702010000000002590035
7777777768012527020000467748000200590001
000001030300252816162a680066774800667777
7748000149003536363637020000005900000001
0066777768000000000000017677776777777777
0100000000014678004677780003010000010100
0046777777776800005901030046777777777777
0059000200000000005900467768020000000000
7768000038000100466801590002000000101111
0002000000000101590001590046780110242121
1111120001490101590000590059020020212121
tilesheet steppe
neighborw 54
neighbors 52
neighbore 59
neighborn 71
sprite 11 5 penguin 0 0 0
sprite 7 7 penguin 0 0 0
song first_frost
