2121212121220000000100351926183700000035
2121212113320200010000002526270000010200
2113313132010200030000013519270000010000
3132000200020000000000000025270000030003
0000030000000100000000000025281702000000
0000000015161700000001000035363701001516
1616161629183700000000004344450000002526
2626262618370000000000005354550000152926
3636363637000000010000006364650000353636
0100010003000000000000000200000000030002
0000000000010200000000000001000202000000
1111111111120000000000000010111111111111
tilesheet steppe
hero 13 8 spell:TELE6
neighborw 52
neighbors 26
neighbore 57
neighborn 59
song first_frost
