0000000000000000000000000000000000002526
0000000000000000000000000000000000002526
0000000000000000000000000000000000002526
0000000000000000000000000000000000002526
0000000000000000000000000000000000003519
0000000000000000000000000000000000000025
0000000000000000000000000000000000000025
0000000000000000000000000000000000000025
0000000000000000000000000000000000000025
0000000000000000000000000000000000000035
0000000000000000000000000000000000000010
1111111111111111111111111111111111111124
tilesheet steppe
song first_frost
neighborw 56
neighbors 27
neighborn 58
neighbore 76
