3700000000000059000001590100590202002021
0200007677777758000200664801664800002021
0000010001000066780100005902025900012021
0000000076480002000046776778006677482021
0001101112667777777768010000000001693014
1710242122000000000000000000001012010020
2730313132000010111111111111112422000020
2700000000001024211331313131141332030020
3700101111112413313200000000202201001024
0000303131313132030003101200303200102421
0200000002000000000002202200000000202121
1111111111111111111111242311111111242121
tilesheet steppe
neighborw 56
neighbors 27
neighborn 58
song first_frost
buried_treasure 17 5 gs:steppe_coins1 item:COIN
