3636363636363636363619262626262626262626
0000000000000000000035192626262626262626
0000000000000000000000351926262626262626
0000000000000000000000002526262626262626
0000000000000000000000003519262626262626
0000000000000000000000000035192626262626
0000000000000000000000000000252626262626
0000000000000000000000000000351926262626
0000000000000000000000000000003536192626
0000000000000000000000000000000000351926
0000000000000000000000000000000000002526
0000000000000000000000000000000000002526
tilesheet steppe
song first_frost
neighbors 57
neighborw 59
neighborn 73
neighbore 75
