36363636361a3701353619262626262627202121
0000000000590000020035192626262627202121
0000010300590000000000351926262627202121
7748007677674800000000002526262627202121
0059020101005900000000003519262627202121
0066774800006677777748000035192627202121
0000006678010000010059000000252627202121
7778000003010000010059030000351927202121
0200014677777747777768000001003537202121
7777776800020059000000000000020000301421
0000010000000059000300467777480000022021
1700000000000059020202590001590000002021
tilesheet steppe
neighbors 57
neighborw 59
neighborn 73
sprite 7 6 penguin 0 0 0
song first_frost
