3636363636363636363619262626262627202121
0000000000000000000035192626262627202121
0000000000000000000000351926262627202121
0000000000000000000000002526262627202121
0000000000000000000000003519262627202121
0000000000000000000000000035192627202121
0000000000000000000000000000252627202121
0000000000000000000000000000351927202121
0000000000000000000000000000003537202121
0000000000000000000000000000000000301421
0000000000000000000000000000000000002021
0000000000000000000000000000000000002021
tilesheet steppe
song first_frost
neighbors 57
neighborw 59
neighborn 73
