18363700351a3636370035361918363636363636
3700000000590002030000012527000000000000
0000000000590100151700002527000101000000
7777777777680200353700003537010000004677
0000000000000002020001101111120002466800
7777777777774800390010242121231202590000
0003000300015900000020212121133200590000
7777774800006677777830313131320001667777
0000006648000000000000001517000000000001
1203020066777777480000032528170033027677
2311120300000100690002032526270000000000
2121231111120000000000152926281700000015
tilesheet steppe
neighbore 58
neighbors 56
neighborw 55
neighborn 72
sprite 5 8 bonfire 0 0 0
sprite 3 10 bonfire 0 0 0
song first_frost
