4a48494a48497a0001000100043a3b3b3b3b3b3b
5a58595a58598a02000000040000010000030001
0000020201010101000400000003010100000000
0000024300013d0101003e000000020000000100
1b1c01000101010101000102020101010002021a
2b2d1b1c0001020200010000010000000104012a
2b2b2b2d1b1b1c0202000000000444450000022a
2b2b2b2b2b2b2d1b1c010000010354550000002a
3b3b3b3b3b3b3b1e2d1c0004010203000000002a
161616161616173a1e2d1c00030104000000002a
26262626262628172a2b2d1b1b1c00010100002a
26262626262626272a2b2b2b2b2d1b1b1b1b1b2e
tilesheet forest
neighborw 1
neighbore 7
sprite 14 7 beehive 0 0 0
neighborn 23
