4a48494a48497a0001000100043a3b3b3b3b3b3b
5a58595a58598a02000000040000010000030001
0100000201010101000400000003010100000000
1b1c014300013d0101003e000000020000000100
2b2d1c000001010101000102020101010002021a
2b2b2d1c0001000200010000010000000104012a
2b2b2b2d1b1c000101020000000444450000022a
2b2b2b2b2b2d1c0202010000010354550000002a
3b3b1e2b2b2b2d1c00000202010203000000002a
16173a3b1e2b2b2c00000000000200000000002a
262816173a1e2b2d1c000000000200000001002a
26262628172a2b2b2c020102000302020300012a
tilesheet forest
song toil_and_trouble
neighborw 1
neighbore 7
sprite 14 7 beehive 0 0 0
neighborn 23
neighbors 24
