4a48494a48497a0001000100043a3b3b3b3b3b3b
5a58595a58598a02000000040000010000030001
0100000201010101000400000003010100000000
1b1c014300013d0101003e000000020000000100
2b2d1c000001010101000102020101010002021a
2b2b2d1c0400010200010000010000000104012a
2b2b2b2d1c02020101020000000444450000022a
2b2b2b1d3c00000000010000010354550000002a
3b3b3b3c0100000200000202010203000000002a
161701000100000400000000000200000000002a
2628161700021a1b1c040001000200030002012a
26262628171a2e2b2d1b1c000003001a1b1b1b2e
tilesheet forest
neighborw 1
neighbore 7
neighborn 23
neighbors 24
sprite 14 7 beehive 0 0 0
sprite 8 5 treadle gs:TEMP 20 0
sprite 10 3 firenozzle_s 2 0 gs:TEMP
song toil_and_trouble
