4a48494a48497a0001000100043a3b3b3b3b3b3b
5a58595a58598a02000000040000010000030001
0100000201010101000000010003010100000000
1b1c014300013d010100c4c00000020000000100
2b2d1c000001010101000000000101010002021a
2b2b2d1c0400010201020000010000000104012a
2b2b2b2d1c020201003e0000000444450000022a
2b2b2b1d3c00000003010100010354550000002a
3b3b3b3c0100000004000203010003000000002a
161701000100003d000100003e0000000000002a
262816170101010001000000010000030002012a
2626262817010000010000000003001a1b1b1b2e
tilesheet forest
saveto spell:HOME
neighborw 1
neighbore 7
neighborn 23
neighbors 24
song toil_and_trouble
