3636192618363636363636361926261836363636
0000353637000000000000003536363700000000
0000000000000000000000000000000000000000
0000000000000000000000000000000000000000
0000000000000000000000000000000000000000
0000000000000000000000000000000000000000
0000000000000000000000000000000000000000
0000000000000000000000101112000000000000
0000000000000000000000202123111112000000
0010111200000000000010242121212123111111
1124212311120000001024212121212121212121
2121212121231111112421212121212121212121
tilesheet steppe
neighbore 54
neighbors 12
neighborw 61
neighborn 69
