2121212121220020220020212121212121212121
2121212121220020220020212121212121212121
2121212121220020220030313131313114212121
2121212121220020220000000000000020212121
2121212121220020231111111111120020212121
2121212121220030311421212121220020212121
2113311421220000002013313131320020212121
2122002021231112002022000000000020212121
2122003031313132002022001011111124212121
2122000000010000002022003031313131313131
2123111111111111112422000100010100020001
2121212121212121212123111111111111111111
tilesheet steppe
neighbore 54
neighbors 12
neighborn 69
song first_frost
