0101010101010101010101010101010101010101
0101010101515151515151515151515151515151
0101010101510000000000000000000000000000
0101010101510000000000000000000000000000
0101010101510000515151515151515151515151
0101010101510000510101010101010101010101
0101010101510000510101010101010101010101
0101010101510000515151515151515101010101
0101010101510000000000000000005101010101
0101010101515151515151515151515101010101
0101010101010101010101010101010101010101
0101010101010101010101010101010101010101
tilesheet villint
saveto spell:HOME
flags dark indoors
neighbore 65
door 14 8 113 14 8
song snowglobe
