d1d1d1d1d1d1d1d1d1d1d1d2e0e1e2d0d1d1d1d1
c2c2c2c2c251515151515151f0f1f25151515151
010101010151c0c0c0c0c0c0c0c0c0c0c0c0c0c0
010101010151c0c0c0c0c0c0c0c0c0c0c0c0c0c0
010101010151c0c0515151515151515151515151
010101010151c0c0510101010101010101010101
010101010151c0c0510101010101010101010101
010101010151c0c0515151515151515101010101
010101010151c0c0c0c0c0c0c0c0c15101010101
0101010101515151515151515151515101010101
0101010101010101010101010101010101010101
0101010101010101010101010101010101010101
tilesheet villint
saveto spell:HOME
flags dark indoors
neighbore 65
neighborn 144
door 14 8 113 14 8
song snowglobe
