3636363636363636361926262626262618363636
0000000000000000003536363636363637000000
0000000000000000000000000000000000000000
0000000000000000000000000000000000000000
0000000000000000000000000000000000000000
0000000000000000000000000000000000000000
0000000000000000000000000000000000000000
0000000000000010111112000000000000000000
0000000000001024212123111112000000000000
0000000010112421212121212123111200000000
1111111124212121212121212121212311111111
2121212121212121212121212121212121212121
tilesheet steppe
neighbore 60
neighbors 22
neighborw 62
neighborn 68
