2122000000202121212121212121212121212121
2122000000202121211331313131313131313131
2122000000202121212200000000000000000000
2122000000202121212200010000000000101111
2122000000202121212200000000000000202121
2122000000202121212200000010111111242121
3132000000304041423200000030313131311421
0000000000005051520000000000505152002021
0000000000000000000000000000000000002021
0000000000000000000000000000000000002021
1111111111111111120010111111111111112421
2121212121212121231124212121212121212121
tilesheet castleint
hero 7 7 spell:TELE4
flags indoors
neighbore 63
neighborw 64
neighborn 76
door 9 10 23 9 4
sprite 9 6 firenozzle_e 3 0 gs:ww_fire1
sprite 13 5 firenozzle_w 3 0 gs:ww_fire1
door 11 3 120 11 3
sprite 16 4 stompbox gs:ww_fire1 0 0
song seven_circles
transmogrify 15 7 from 1
