2121212200000000202121212121212121212121
2121212200000000201331313131313131313131
2121212200000000202200000000000000000000
2121212200000000202200010000000000101111
2121212200000000202200000000000000202121
2121212200000000202311111200001011242121
3131313200000000304041423200003031313131
0000000000000000005051520000000000000000
0000000000000000000000000000000000000000
0000000000000000000000000000000000000000
1111111111111111120010111111111111111111
2121212121212121231124212121212121212121
tilesheet castleint
hero 10 7 spell:TELE4
flags indoors
neighbore 63
neighborw 64
neighborn 76
door 9 10 23 9 4
sprite 12 6 firenozzle_e 2 0 gs:ww_fire1
sprite 15 5 firenozzle_w 2 0 gs:ww_fire1
door 11 3 120 11 3
sprite 16 4 stompbox gs:ww_fire1 0 0
song seven_circles
