3636363619262626262626262626262626261836
0000000035363636192626262626261836363700
0000000000000000353619261836363700000000
0000000000000000000035363700000000000000
0000000000000000000000000000000000000000
0000000000000000000000000000000000000000
0000000000000000000000000000000000000000
0000000000000000000000101200000000000000
0000001012000000000010242312000000000000
0000102423120000001024212123111200000000
0010242121231111112421212121212311111111
1124212121212121212121212121212121212121
tilesheet steppe
neighbore 61
neighbors 47
neighborw 63
neighborn 67
