3636192618363619262626183636192626261836
0000353637000035363636370000353636363700
0000000000000000000000000000000000000000
0000000000000000000000000000000000000000
0000000000000000000000000000000000000000
0000000000000000000000000000000000000000
0000000000000000000000000000000000000000
0000000000000000000000000000000000000000
0000000000000000001012000000000000000000
0000101112000000102423120000001011120000
0010242123120010242121231111112421231200
1124212121231124212121212121212121212311
tilesheet steppe
song first_frost
neighbore 62
neighbors 48
neighborw 64
neighborn 66
