2121212121212121212200000020212200000020
3131313131313131313200000020212200000020
0000000000000000000000000020212200000020
1111111112000000000000000020212200000020
2121212122000000000000000020212200000020
2121212123111111111111111124212200000020
2121212121212121212121212121212200000020
2121212121212121212121212121212311111124
2121212121212121212121212121212121212121
2121212121212121212121212121212121212121
2121212121212121212121212121212121212121
2121212121212121212121212121212121212121
tilesheet castleint
flags indoors
neighborw 62
neighborn 77
sprite 3 2 bonfire 0 0 0
sprite 17 5 bonfire 0 0 0
