2121212121212121212121212121212121212121
3131313131313131141331313131313131142121
0000000000000000202200000000000000202121
0000000000000100202200000000000000202121
0000000000000000202200005051520000202121
1111111111111111242200000000000000202121
3131313131313131313200000000000000202121
0000000000000000000000000010111111242121
0000000000000000000000000020212121212121
0000000000000000000000000020212121212121
1111111111111111111111111124212121212121
2121212121212121212121212121212121212121
tilesheet castleint
flags indoors
neighborw 62
neighborn 77
door 6 3 121 6 3
transmogrify 13 4 from 1
