2121212121212121212121212121212121212121
3131313131313131141331313131313131142121
0000000000000000202200000000000000202121
1111111112000100202200000000000000202121
2121212122000000202200005051520000202121
2121212123111111242200000000000000202121
3131313131313131313200000000000000202121
0000000000000000000000000010111111242121
0000000000000000000000000020212121212121
0000000000000000000000000020212121212121
1111111111111111111111111124212121212121
2121212121212121212121212121212121212121
tilesheet castleint
flags indoors
neighborw 62
neighborn 77
door 6 3 121 6 3
sprite 3 2 bonfire 0 0 0
transmogrify 13 4 from 1
