2121212121212121212121212121212121212121
2113313131313131313131313131313131311421
2122000000000000000000000000000000002021
2122000000000000000000000000000000002021
2122000000000000000000000000000000002021
2122000000101111111111111111120000002021
2122000000202121212121212121220000003031
2122000000202121212121212121220000000000
2122000200202121212121212121220000000000
2122000000202121212121212121220000000000
2123111111242121212121212121231111111111
2121212121212121212121212121212121212121
tilesheet castleint
flags indoors
neighbore 62
door 3 8 65 2 9
neighborn 75
