2626262626262626262626261836363636363636
2626262626262626262618363700000000000000
2626262626262626183637000000000000000000
2626262626262618370000000000000000000000
2626262626261837000000000000000000000000
2626262626183700000000000000000000000000
2626261836370000000000000000000000000000
2626183700000000000000000000000000000000
2618370000000000000000000000000000000000
2627000000000000000000000000000000000000
3637000000000000000000000000000000000000
1111111111111111111111111111111111111111
tilesheet steppe
song first_frost
neighbore 63
neighbors 51
neighborn 65
neighborw 99
