5454545454545454545454545454545454545454
6464646464646447545454545454545454545454
0000000000000053545454545454545454545454
0000000000000053545454545454545454545454
4444444444450053545454545454545454545454
5454545454564457545454545446646448646464
4664646464646447545454545455000000000000
5500000000000053545454545455000000000000
5500000043450063646464646465000043444444
5500010053550000000000000000000053545454
5500000053564444444444444444444457545454
5644444457545454545454545454545454545454
tilesheet castleint
flags dark indoors multihome
neighborw 61
neighbore 66
neighborn 68
door 2 9 64 3 8
sprite 6 6 firenozzle_s 3 0 gs:ww_fire3
sprite 6 4 stompbox gs:ww_fire3 0 0
