2121212121212121212121212121212121212121
3131313131313114212121212121212121212121
0000000000000020212121212121212121212121
0000000000000020212121212121212121212121
1111111111120020212121212121212121212121
2121212121231124212121212113313131313131
1331313131313114212121212122000000000000
2200000000000020212121212122000000000000
2200000010120030313131313132000010111111
2200010020220000000000000000000020212121
2200000020231111111111111111111124212121
2311111124212121212121212121212121212121
tilesheet castleint
saveto spell:TELE4
flags dark indoors
neighborw 61
neighbore 66
neighborn 68
door 2 9 64 3 8
sprite 6 6 firenozzle_s 3 0 gs:ww_fire3
sprite 6 4 stompbox gs:ww_fire3 0 0
song seven_circles
