5454545454545454550053545454545454545454
5454545454545454550053545454545454545454
5454545454466464650063475454545454545454
5454545454550303030303535454545454545454
5446646464650303030303535454545454545454
6465000000000303030303535454545454545454
0000004344450303030303535454545454545454
0000005354550303030303535454545454545454
4444445754564444444444575454545454545454
5454545454545454545454545454545454545454
5454545454545454545454545454545454545454
5454545454545454545454545454545454545454
tilesheet castleint
saveto spell:TELE4
flags dark indoors
neighborw 65
neighborn 67
sprite 6 3 trickfloor 0 0 0
song seven_circles
