2121212121212121220020212121212121212121
2121212121212121220020212121212121212121
2121212121133131320030142121212121212121
2121212121220303030303202121212121212121
2113313131320303030303202121212121212121
3132000000000303030303202121212121212121
0000001011120303030303202121212121212121
0000002021220303030303202121212121212121
1111112421231111111111242121212121212121
2121212121212121212121212121212121212121
2121212121212121212121212121212121212121
2121212121212121212121212121212121212121
tilesheet castleint
flags dark indoors
neighborw 65
neighborn 67
sprite 6 3 trickfloor 0 0 0
