2122000000000000000020212121212121212121
2122000000000000000020212121212121212121
2122000000000000000020212121212121212121
2122000000000000000020212121212121212121
2122000000000000000020212121212121212121
2122000000000000000030313131313131313131
2122000000000000000000000000000000000000
2122000000000000000000000000000000000000
3132000010111111120000000000000000000000
0000000020212121220000000000000000000000
0000000020212121220010111111111111111111
1111111124212121220020212121212121212121
tilesheet castleint
flags indoors
neighbors 66
sprite 2 0 firewall 0 0 0
sprite 19 6 firewall 0 0 0
neighborw 68
