1331313114133131313131313131313131313114
2200000020220400040004000000000000000020
2200010020220000040000000000000000000020
2200000020220004040404040400000404000020
2200000020220000000004000400000404000020
2233003330320004000000000400000000000020
2200000000000004000404040400000000000020
2200330010120004000004000000000004040420
2200000020220004040004000404000004040430
2233003320220404000000000404000000000000
2200000020220000000404000404000000000000
2311111124231111111111111111111111111111
tilesheet castleint
flags dark indoors
neighbore 67
neighbors 65
door 2 2 75 2 2
