4664646447466464646464646464646464646447
5500000053550400040004000000000000000053
5500010053550000040000000000000000000053
5500000053550004040404040400000404000053
5500000053550000000004000400000404000053
5566006663650004000000000400000000000053
5500000000000004000404040400000000000053
5500660043450004000004000000000004040453
5500000053550004040004000404000004040463
5566006653550404000000000404000000000000
5500000053550000000404000404000000000000
5644444457564444444444444444444444444444
tilesheet castleint
flags dark indoors
neighbore 67
neighbors 65
door 2 2 75 2 2
