2121212121212121212121212121212121212121
2121212121212121212121212121212121212121
2121212121212121212121212121212121212121
2121212121212121212121212121212121212121
2121212113313131313131313131142121212121
2121212122000000000000000000202121212121
2121212122001011111111111200303131313131
2121212122003031313114212203000300020000
2121212122020300000120212311111111111111
2121212123120010120220212121212121212121
2121212121220020220020212121212121212121
2121212121220020220020212121212121212121
tilesheet steppe
neighbors 60
neighbore 70
