3b3b3b3c00000000005152525252525252525252
0100000001000000016145525252446262624552
0000000000000000000061626262637071725152
0200000000640000000000000000008081825152
1c01000000000000000000000000009091925152
2d1c000101010000004b4d000000000000006145
2b2c02000000004b4c5f5e4d0000000000000061
2b2d1c000000015b5c5c5c5e4c4d000000000000
2b2b2c000000006b6c4f5c5c5c5e4c4d00004142
2b2b2d1c03010000006b4f5c5c5c5c5d00006162
2b2b2b2c0100010101005b5c5c5c5c5d00020200
2b2b2b2c0000000000005b5c5c5c5c5e4c4c4c4c
tilesheet desert
hero 16 4 spell:TELE5
neighborw 6
neighbore 8
neighborn 10
neighbors 28
song blood_for_silver
