3b3b3b3c00000000005152525252525252525252
0100000001000000016145525252446262624552
0000000000000000000061626262637071725152
0200000000000000000000000000008081825152
1c01000000000000000000000000009091925152
2c00000101010000000000000000000000006145
2c00020000000000000000000000000000000061
2c000000000001000000004b4c4d000000000000
2c0000000000000000004b5f5c5e4c4d00004142
2c0000040301000000005b5c5c5c5c5d00006162
2c0204000100010101005b5c5c5c5c5d00020200
2d1b1b1c0000000000005b5c5c5c5c5e4c4c4c4c
tilesheet desert
hero 16 4 spell:TELE5
neighborw 6
neighbore 8
neighborn 10
neighbors 28
song blood_for_silver
