3b3b3b3c000000000000000000000000003a3b3b
0100000001000000010200000001010002010003
0000000000000000000000000000000000000000
0200000000000000000000000000000000000101
1c0100000000000000000000000000000000001a
2c0000010101000000000000000000000001012a
2c0002383900000000000000000000000000022a
2c0000380039010000000000000000000001022a
2c0000383800000000000000000000000000022a
2c0000040301000000000000000000000000012a
2c0204000100010101000001000001010002022a
2d1b1b1c000000000000000000000000001a1b2e
tilesheet desert
song blood_for_silver
neighborw 6
neighbore 8
neighborn 10
neighbors 28
sprite 18 6 treasure item:BROOM 0 0
sprite 18 9 treasure item:BELL 0 0
