2121212121133131322526262626262626262626
2121211331321516162926262626262626262626
2121133215162926262626262626262626262626
2113321529262626262626262626262626262626
2122152926262626262626262626262626262626
212225262626262626183636363636191b262626
3132353636363636363700000000003536361926
0001000000000000000000001517000000002526
1111111215161616161617002528161616162926
2121212235192626261837002526262626262626
2121212312252626262703012526262626262626
2121212122252626262703152926262626262626
tilesheet steppe
flags ancillary blowback
neighborw 69
neighbors 54
neighbore 71
sprite 13 3 nffish 0 0 0
sprite 6 7 penguin 0 0 0
