2121212121133131322526262626262626262626
2121211331321516162926262626262626262626
2121133215162926262626262626262626262626
2113321529262626262626262626262626262626
2122152926262626262626262626262626262626
1332252626262626262626262626262626262626
2215292626262626262626262626262626262626
2225262626262626262626262626262626262626
2225262626262626262626262626262626262626
2225262626262626262626262626262626262626
2225262626262626262626262626262626262626
2225262626262626262626262626262626262626
tilesheet steppe
neighborw 69
neighbors 54
flags ancillary blowback
neighbore 71
