2121212121133131322526262626262626262626
2121211331321516162926262626262626262626
2121133215162926262626262626262626262626
2113321529262626262626262626262626262626
2122152926262626262626262626262626262626
2122252626262626261836363636361926262626
3132353636363636363700000000002526262626
0001000000000000000000151617012526262626
1111111215161616161702252627003536192626
2121212235192626262700252627000000252626
2121212312252626262700252628161616292626
2121212122252626262700252626262626262626
tilesheet steppe
flags ancillary blowback
neighborw 69
neighbors 54
neighbore 71
