2626262626262626262626262626262626262626
2626262626262626262626262626262626262626
2626262626262626262626262626262626262626
2626262626262626262626262626262626262626
2626262626262626262626262626262626262626
2626262626261836363636192626262626262626
2626262626262700000000351926262626262626
2626262626262700000000002526262626262626
2626262626262817000000002526262626262626
2626262626262628161616162926262626262626
2626262626262626262626262626262626262626
2626262626262626262626262626262626262626
tilesheet steppe
flags ancillary blowback
neighborw 70
neighbors 55
neighbore 72
