2626262626262626262626262626262626262626
2626262626262626262626262626262626262626
2626262626262626262626262626262626262626
2626262626262626262626262626262626262626
2626262626262626262626262626262626262626
2626262626262618363636192626262626262626
2626262626262627000100252626262626262626
2626262626262627010001252626262626262626
3636361926262627000100252626262626262626
0100002526262628161616292626262626262626
1616162926262626262626262626262626262626
2626262626262626262626262626262626262626
tilesheet steppe
flags ancillary blowback
neighborw 70
neighbors 55
neighbore 72
buried_treasure 9 7 gs:snowglobe item:SNOWGLOBE
