2626262626262626262626262626262626262626
2626262626262626262626262626262626262626
2626262626262626262626262626262626262626
2626262626262626262626262626262626262626
2626262626262626262626262626262626262626
2626262626262626183636361926262626262626
1836363636363636370000033536363636363619
2700000000000001000000000000000000000025
2816170015161616170200001516161616170025
262627004a3636363a7777773b36363619270025
2626270059000200000002000000000125270025
2626270359001516161616161616170025270025
tilesheet steppe
flags ancillary blowback
neighborw 70
neighbors 55
neighbore 72
sprite 8 1 nffish 0 0 0
buried_treasure 10 7 gs:snowglobe item:BELL
