2626262626262626262626262626262626262626
2626262626262626262626262626262626262626
2626262626262626262626262626262626262626
2626262626262626262626262626262626262626
2626262626262626262626262626262626262626
2626183636363636192626262626262626262626
2626270001000003353636363636361926262626
2626270015161700000000000000002526262626
2626270025262816161616161617003536363636
2626270025262626183636363637000000000000
2626270025262626270100000000001516161616
2626270025262626270015161616162926262626
tilesheet steppe
flags ancillary blowback
neighborw 71
neighbors 59
neighbore 73
