2626262626262626262626262730311421212121
2626262626262626262626262816173014212121
2626262626262626262626262626281730142121
2626262626262626262626262626262817202121
2626262626262626262626262626262627202121
2626262626262626262626262626262627202121
2626262626262626262626262626262627202121
2626262626262626262626262626262627202121
2626262626262626262626262626262627202121
2626262626262626262626262626262627202121
2626262626262626262626262626262627202121
2626262626262626262626262626262627202121
tilesheet steppe
flags ancillary blowback
neighborw 72
neighbors 58
neighbore 74
