2626262626262626262626262730311421212121
2626262626262626262626262816173014212121
2626262626262626262626262626281730142121
2626262626262626262626262626262817202121
2626262626262626262626262626262627202121
2626262626262626262626262626262627202121
2626262626262626262626183619262627202121
2626183636363636363636370025262627202121
3636370000000000010000000025262627202121
0000000015161700151616161629262627202121
1616161629262700252626262626262627202121
2626262626262700252626262626262627202121
tilesheet steppe
flags ancillary blowback
neighborw 72
neighbors 58
neighbore 74
