1331313131141331313131142121220000202121
2200000000202200000000202121220000303131
3200101200202200101200202121220000000000
0000202200202200202200202121220000000000
1111242200303200202200303114220000001011
2121212200000000202200000020220000002021
2121212311111111242311111124220000002021
2121211331313131313131313131320000002021
2121212200000000000000000000000000002021
2121212200000000000000000000000000002021
2121212200000000000000000000000000002021
2121212200000000101111111111111111112421
tilesheet castleint
flags indoors
neighborw 75
neighbors 62
sprite 12 5 stompbox gs:ww_fire4 0 0
sprite 14 5 firenozzle_e 3 0 gs:ww_fire4
sprite 11 5 bonfire 0 0 0
neighbore 77
neighborn 97
