2626262626262626262626262626262626262626
2626262626262626262626262626262626262626
2626262626262626262626262626262626262626
2626262626262626262626262626262626262626
2626262626262626262626262626262626262626
2626262626262626262626262626262626262626
2626262626262626262626262626262626262626
2626262626262626262626262626262626262626
2626262626262626262626262626262626262626
3636361926262626262626262626262626262626
1111122526262626262626262626262626262626
2121222526262626262626262626262626262626
tilesheet steppe
neighborn 75
neighborw 57
flags ancillary blowback
neighbors 77
