2121212121212121212200000030313131313114
1331313131313131313200000000000000000020
2200000000000000000000000000000000000020
2200000000000000000000000000000000000020
2200000000000000000000000000000000000020
2200000000000000000000000000000000000020
2200000000000000000000000000000000000020
2200030303000000000300000000000000000020
2200000300030300030300030300000000000020
2200000300030300030300030300000000000020
2200000000000000000000000000000000000020
2311111112000000101111111111111111111124
tilesheet castleint
flags indoors
neighborw 76
neighbors 63
neighborn 78
