2b2b2c2526262626262626262626262626262626
2b2b2c2526262626262626262626262626262626
2b2b2c2526262626262626262626262626262626
2b2b2c2526262626262626262626262626262626
2b2b2c2526262626262626262626262626262626
2b1d3c2526262626262626262626262626262626
2b2c152926262626262626262626262626262626
2b2c252626262626262626262626262626262626
2b2c252626262626262626262626262626262626
2b2c252626262626262626262626262626262626
2b2c252626262626262626262626262626262626
2b2c252626262626262626262626262626262626
tilesheet beach
neighborn 76
neighborw 27
flags ancillary blowback
neighbors 78
