2121212121212121212121212121212121212121
1331313131313131313131313131313131311421
2200000000000000000000000000000000002021
2200000000000303030000000003000000002021
3200000000000003000303000303000303002021
0000000000000003000303000303000303002021
0000000000000000000000000000000000002021
1200000000000000000000000000000000002021
2200000000000000000000000000000000002021
2200000000000000000000000000000000002021
2200000000000000000000000000000000002021
2311111111111111111200000010111111112421
tilesheet castleint
flags indoors
neighbors 77
neighborw 97
