2121212121212121212121212121212121212121
2121211331313131313131313131313131311421
2121212200000000000000000000000000002021
2121212200101111111200101111111112002021
3131142200202121212200202121212122002021
0000202200303131313200303131313132002021
0000202200000000000000000000000000002021
1200202200000000000000000000000000002021
2200202311111200101200000010111111112421
2200303131313200202200000020212121212121
2200000000000000202200000020212121212121
2311111111111111242200000020212121212121
tilesheet castleint
flags indoors
neighbors 77
neighborw 97
sprite 13 6 pushblock 0 0 0
sprite 13 9 firenozzle_w 3 0 gs:ww_fire8
sprite 7 2 treadle gs:ww_fire8 0 0
sprite 12 2 treadle gs:ww_fire9 0 0
sprite 9 8 firenozzle_e 3 0 gs:ww_fire9
sprite 8 6 pushblock 0 0 0
