2b2c252626262626262626262626262626262626
2b2c252626262626262626262626262626262626
2b2c252626262626262626262626262626262626
2b2c252626262626262626262626262626262626
1d3c252626262626262626262626262626262626
2c15292626262626262626262626262626262626
2c25262626262626262626262626262626262626
2c25262626262626262626262626262626262626
2c25262626262626262626262626262626262626
2c25262626262626262626262626262626262626
2c25262626262626262626262626262626262626
2c25262626262626262626262626262626262626
tilesheet beach
song eye_of_newt
neighborn 77
neighborw 9
neighbors 79
flags ancillary blowback
