525252525300000000005153000000000000005b
525252446300030001005153000000040001005b
525252530000000000005153000000000000005b
525244630000000000005153001516161617035b
525253000000000000005153002526262627005b
524463000002000000005153002526262627015b
626304000000010000415553003536363637005b
000000000000010041554463000000000000025b
424242424242424255446300000000000000005b
626262626262626262630000000000000000015b
000104000100010000000201040103000101005b
4c4c4d00000000004b4c4c4c4d0000000000005b
tilesheet desert
neighborw 7
neighbore 9
neighborn 26
neighbors 29
song blood_for_silver
buried_treasure 7 4 gs:desert_coins1 item:COIN
