3b3b3b3b3b3b3b3b3b3b3b3b3b3b3b3b3b3b3b3b
0400010000000300010002010003000400010001
0000000000000000000000000000000000000000
0001000000000000000000000000000000000301
1c0000000000000000000000000000000000001a
2c0000000002000000000000000000000000012a
2c0004393838010000000000000000000000002a
2c0000020039010000000000000000000000022a
2c0100000238000000000000000000000000002a
2c0000000001010000000000000000000000012a
2c0104000100010000000201040103000101002a
2d1b1b1b1b1b1b1b1b1b1b1b1b1b1b1b1b1b1b2e
tilesheet midlands
neighborw 7
neighbore 9
