3b3b3c0000000000000000000000000000000000
0400010000000300010002010003000400010001
0000000000000000000000000000000000000000
0001000000000000000000000000000000000301
1c00000000000000000000000000000000000000
2c00000000020000000000000000000000000100
2c00043939000100000000000000000000000000
2c00003800390100000000000000000000000200
2c01003938000000000000000000000000000000
2c00000000010100000000000000000000000100
2c01040001000100000002010401030001010000
2d1b1b1b1b1c0000000000000000000000000000
tilesheet desert
neighborw 7
neighbore 9
neighborn 26
neighbors 29
