2b2b2b1d3b3b3b3b3b1e2b2b2b2b2b2b2b2b2b2b
3b3b3b3c15161616173a3b3b3b3b3b3b1e2b2b2b
161616162926262628161616161616173a3b3b3b
2626262626262626262626262626262816161616
2626262626262626262626262626262626262626
2626262626262626262626262626262626262626
2626262626262626262626262626262626262626
2626262626262626262626262626262626262626
2626262626262626262626262626262626262626
2626262626262626262626262626262626262626
2626262626262626262626262626262626262626
2626262626262626262626262626262626262626
tilesheet beach
flags ancillary blowback
neighborn 79
neighborw 34
neighbors 81
