3b3b3b3b3b3b3b3b3b1e2b2b2b2b2b2b2b2b2b2b
1616161616161616173a3b3b3b3b3b3b1e2b2b2b
262626262626262628161616161616173a3b3b3b
2626262626262626262626262626262816161616
2626262626262626262626262626262626262626
2626262626262626262626262626262626262626
2626262626262626262626262626262626262626
2626262626262626262626262626262626262626
2626262626262626262626262626262626262626
2626262626262626262626262626262626262626
2626262626262626262626262626262626262626
2626262626262626262626262626262626262626
tilesheet beach
neighborn 79
neighborw 34
flags ancillary blowback
neighbors 81
