0000000000000000000000000000000000000051
0100000001000200010201010000020100000151
0000000000000000000000000000000000000051
0000000000000000000000000000000000000151
0000000000000000000000000000000000000251
0002000200000300000000000000000000000151
0002010000000339390000000000000000000051
0003010000000339003900000000000000000051
0001010000000039390000000000000000000051
0000000000000000000000000000000000000251
0001030300000102010000010001000102000451
0000000000000000000000000000000000000051
tilesheet desert
neighborw 8
neighborn 27
neighbors 30
neighbore 78
