5c5d006b6c6c6c6c6c6c6d005b5c5c5c5c5c5c5c
5c5d00000100026f010201015b5c5c5c5c5c5c5c
5c5e4c4c4c4d006f004b4c4c5f5c5c5c5c5c5c5c
5c5c5c4e6c6d0000006b6c6c6c4f5c5c5c5c5c5c
5c4e6c6d0000000000000000006b6c6c4f5c5c5c
4e6d00020000030000000000000000006b4f5c5c
5d020100000003000000000000000000006b4f5c
5d03010000000300000000000000000000005b5c
5d01010000464747474747474747474748005b5c
5d000000465a5749676767676767674a58005b5c
5d0103465a575758010000010001005658005b5c
5d00465a57575759474747474748005658005b5c
tilesheet desert
neighborw 8
neighborn 27
neighbors 30
sketch 9 3 853504
sketch 10 3 606243
sketch 11 3 99466
sketch 12 3 265860
sprite 7 3 chalkguard 1 2 0
song blood_for_silver
