3b3b3b3b3b3b3b3b3b3b3b3b3b3b3b3b3b3b3b3b
0100000001000200010201010000020100000200
0000000000000000000000000000000000000000
0000000000000000000000000000000000000001
1c0000000000000000000000000000000000001a
2c0200020000030000000000000000000000012a
2c0201151617030000000000000000000000002a
2c0301252627030000000000000000000000002a
2c0101353637000000000000000000000000002a
2c0000000000000000000000000000000000022a
2c0103030000010201000001000100010200042a
2d1b1b1b1b1b1b1b1b1b1b1b1b1b1b1b1b1b1b2e
tilesheet midlands
neighborw 8
neighbore 10
