3131313131313131313131313131313131313131
4141414141414141414141414141414141414141
5151515151515151515151515151515151515151
5151515151515151515151515151515151515151
5151515151515151515151515151515151515151
5151515151515151515151515151515151515151
5151515151515151515151515151515151515151
5151515151515151515151515151515151515151
5151515151515151515151515151515151515151
5151515151515151515151515151515151515151
5151515151515151515151515151515151515151
5151515151515151515151515151515151515151
tilesheet swamp
neighbors 94
neighbore 43
flags ancillary blowback
neighborn 96
