5151515151515151515151515151515151515230
5151515151515151515151515151515151515341
5151515151515151515151515151515151515151
5151515151515151515151515151515151515151
5151515151515151515151515151515151515151
5151515151515151515151515151515151515151
5151515151515151515151515151515151515151
5151515151515151515151515151515151515151
5151515151515151515151515151515151515151
5151515151515151515151515151515151515151
5151515151515151515151515151515151515151
5151515151515151515151515151515151515151
tilesheet swamp
neighbors 94
neighbore 43
blowback
neighborn 96
