5151515151515151515151515151515151515220
5151515151515151515151515151515151515220
5151515151515151515151515151515151515220
5151515151515151515151515151515151515220
5151515151515151515151515151515151436220
5151515151515151515151515151515151521024
5151515151515151515151515151515151523014
5151515151515151515151515151515151534220
5151515151515151515151515151515151515220
5151515151515151515151515151515151515220
5151515151515151515151515151515151515220
5151515151515151515151515151515151515220
tilesheet swamp
song gloom_for_company
neighbors 95
neighbore 5
neighborn 97
flags ancillary blowback
