2121212121212121212121212121212121212121
2121212121133131313131313131311421212121
2121212121220000000000000000002021212121
2121212121220000000000000000002021212121
2121212121220000101111111200002021212121
2121212121220000201331142200003031313131
2121212121220000202200202200000000000000
2121212121220000202200202200000000000000
3131313131320000202200202311111111111111
0000000000000000202200303131313131142121
0000000000000000202200000000000000202121
1111111111111111242311111111120000202121
tilesheet castleint
flags indoors
neighbore 78
neighbors 76
sprite 10 4 firenozzle_n 2 0 gs:ww_fire5
sprite 10 6 stompbox gs:ww_fire5 0 0
neighborw 98
