2121212121212121212121212121212121212121
3131313131063131310731313131311421212121
0000000004040400000000000000002021212121
0000000000000000040404000000003031311421
1111111111111111111111111200000000003031
2121212121212121211331142200000000000000
2121212121212121212200202200000000000000
2121212121212121212200202311111111111111
3131313131313131313200303131313131311421
0000000000000000000000000000000000002021
0000000000000000000000000000000000002021
1111111111111111111111111111120000002021
tilesheet castleint
flags indoors
neighbore 78
neighbors 76
neighborw 98
sprite 10 4 firenozzle_n 2 0 gs:ww_fire5
sprite 10 6 stompbox gs:ww_fire5 0 0
sprite 17 4 pitchfork 0 0 0
