2121212121212121212121212121212121212121
2121212121212113313131313131313131313131
2121212121212122000000000000000000000000
2121212121212122000000000000000000000000
2121212121212122000000000010111111111111
2121212121212122000000000020212121212121
2121212121212122000000000020212121212121
2121212121212122000000000020212121212121
2121212121212122000000000030313131313131
2121212121212122000000000000000000000000
2121212121212122000000000000000000000000
2121212121212123111111111111111111111111
tilesheet castleint
flags indoors
neighbore 97
neighbors 75
sprite 14 4 firenozzle_n 2 0 gs:ww_moonswitch
sprite 10 3 treadle gs:ww_moonswitch 0 0
sprite 10 6 moonsong gs:moonsong 0 0
