2121212121212121211331313131313131313114
2121212121212121212200000000000000000020
2113313131313131313200000000000000000020
2122000000000000000000000000000000000020
2122000000000000000000000000000000000020
2122000000000000000000000000000000000020
2122000000101111111200000000000000000020
2122000000202121212200000000000000000020
2122000100202121212200000000000000000030
2122000000202121212200000000000000000000
2123111111242121212200000000000000000000
2121212121212121212311111111111111111111
tilesheet castleint
flags indoors
neighbore 97
neighbors 75
sprite 8 2 firenozzle_s 3 0 gs:ww_moonswitch
sprite 11 2 treadle gs:ww_moonswitch 0 0
sprite 14 5 moonsong gs:moonsong 0 0
door 3 8 99 3 8
