2626262626262626262626262626262626262626
2626262626262626262626262626261836363636
2626262626262626262618363636363700000000
1836363636363636363637000000000000151616
27007b7c7d7e0000000000000015161616292626
27008b8c8d8e0000000000000035363636192626
279a9b9c9d9e9f00000000004b4c4d4e00252626
2816161617000000000000005b5c5d5e00252626
26262626270000000000006a6b6c6d6e6f252626
2626262627000000151616161616161616292626
2626262627000000252626262626262626262626
2626262627000000252626262626262626262626
tilesheet castleint
flags indoors
neighbore 100
neighbors 118
sprite 11 8 dragon 0 0 0
sprite 6 6 dragon 8 255 0
