2121212121212121212121212121212121212121
2121212121212121212121212121211331313131
2121133131313131313131313131313200000000
2121220000000000000000000000000000101111
2121220003030300030000000000000000202121
2121220000030003030000000000000000202121
2121220000030003030000000000000000202121
2121220000000000000000000000000000202121
2121220200000000000000000000000000202121
2121231111111111111111111111111111242121
2121212121212121212121212121212121212121
2121212121212121212121212121212121212121
tilesheet castleint
flags indoors
door 3 8 98 3 8
neighbore 100
neighbors 118
