2626262626262626262626262626262626262626
2626262626262626262626262626261836363636
2626183636363636363636363636363700000000
2626270000000000000000000000000000151616
2626270003030300030000000000000000252626
2626270000030003030000000000000000252626
2626270000030003030000000000000000252626
2626270000000000000000000000000000252626
2626270000000000000000000000000000252626
2626281617000000151616161616161616292626
2626262627000000252626262626262626262626
2626262627000000252626262626262626262626
tilesheet castleint
flags indoors
neighbore 100
neighbors 118
